...Ready For It?	Taylor Swift	reputation	3:28
(Sittin' On) the Dock of the Bay	Otis Redding	The Very Best of Otis Redding	2:46
@ my worst	blackbear	misery lake [Explicit]	3:11
&burn	Billie Eilish	dont smile at me	2:59
3 (Glee Cast Version)	Glee Cast	Britney 2.0	3:27
3, 2, 2001	24kgoldn	El Dorado [Explicit]	2:11
4th Wall	Simply Three	Undefined	4:25
8	Billie Eilish	WHEN WE ALL FALL ASLEEP, WHERE DO WE GO?	2:53
10,000 Armies (Live)	Influence Music	ages (Live)	5:43
10,000 Reasons (Bless The Lord) (Live)	Matt Redman	10,000 Reasons (Live)	5:42
21 Guns	Green Day	21st Century Breakdown [Explicit]	5:22
21 Reasons (feat. Ella Henderson)	Nathan Dawe [feat. Ella Henderson]	21 Reasons (feat. Ella Henderson)	2:35
27 Club (Fhin Flip)	Chløë Black [feat. Fhin]	27 Club (Fhin Flip)	4:20
96,000	Lin-Manuel Miranda	In the Heights (Original Broadway Cast Recording)	5:35
100 Bad Days	AJR	Neotheater [Explicit]	3:32
300 Violin Orchestra	Jorge Quintero	Hip Hop and Rnb Instrmentals	2:58
A 1000 Times	Hamilton Leithauser & Rostam	I Had a Dream That You Were Mine	4:08
A Beautiful Noise	Alicia Keys & Brandi Carlile	A Beautiful Noise	3:19
A Safe Zone	VARIOUS ARTISTS	Kipo And The Age Of Wonderbeasts (Season 3 Mixtape)	1:07
Aaron Burr, Sir	Lin-Manuel Miranda	Hamilton (Original Broadway Cast Recording) [Explicit]	2:36
abc (nicer)	GAYLE	abc (nicer) [Clean]	2:48
ABC Café / Red & Black	Les Misérables Cast	Les Misérables: The Motion Picture Soundtrack Deluxe (Deluxe Edition)	4:21
Abundantly More (feat. Seth Condrey)	North Point Worship	Abundantly More	4:01
Achilles Come Down	Gang Of Youths	Go Farther In Lightness [Explicit]	7:02
Across the Starlit Sky	Jennifer Thomas	Illumination	4:06
The Actor	alt-J	The Dream [Explicit]	4:00
The Adams Administration	Lin-Manuel Miranda	Hamilton (Original Broadway Cast Recording) [Explicit]	0:54
Adeste Fideles	Bing Crosby	White Christmas	3:10
Aerials	System Of A Down	Toxicity	3:55
African Zombie	Alex Boyé	Africanized	3:24
After the Gold Rush (2017 Remaster)	Neil Young	Decade	3:45
Aftermath	Caravan Palace	<I°_°I>	3:06
Afterword (Interlude)	TobyMac	Momentum	1:02
Age of Wonderbeasts	VARIOUS ARTISTS	Kipo And The Age Of Wonderbeasts (Season 1 Mixtape) [Clean]	0:29
The Age of Wonderbeasts	VARIOUS ARTISTS	Kipo And The Age Of Wonderbeasts (Season 3 Mixtape)	2:24
Agony	VARIOUS ARTISTS	Into the Woods (Original Motion Picture Soundtrack)	2:31
Agony	Original Broadway Cast of Into the Woods	Into the Woods (Original Broadway Cast Recording)	2:27
Agony (reprise)	Original Broadway Cast of Into the Woods	Into the Woods (Original Broadway Cast Recording)	2:16
Ain't Killed Me Yet	Eric Church	Carolina	3:22
Ain't Misbehavin' (I'm Savin' My Love for You)	Helen O'Connell	I've Got the World On a String	2:25
Airplanes (feat. Hayley Williams of Paramore)	B.o.B	B.o.B Presents: The Adventures of Bobby Ray [Explicit]	3:00
Alabama (2009 Remaster)	Neil Young	Harvest (2009 Remaster)	4:02
Alabanza	In The Heights (Original Cast Recording)	In The Heights	3:15
Alaska (Acoustic)	Amber Run	Alaska (Acoustic)	2:35
Alejandro	Lady Gaga	The Fame Monster (Deluxe Edition) [Explicit]	4:34
Alexander Hamilton	Lin-Manuel Miranda	Hamilton (Original Broadway Cast Recording) [Explicit]	3:56
Alive In You (Live) [feat. Kim Walker-Smith]	Jesus Culture	Let It Echo (Live)	5:14
All Around Me	Flyleaf	Flyleaf (Deluxe Edition)	3:19
All Around The World (La La La)	R3HAB & A Touch Of Class	All Around The World (La La La)	2:27
All Er Nuthin'	VARIOUS ARTISTS	Oklahoma! (2019 Broadway Cast Recording)	3:50
All For Us (from the HBO Original Series Euphoria)	Labrinth & Zendaya	All For Us (from the HBO Original Series Euphoria)	3:13
All Hallow's Eve	VARIOUS ARTISTS	Meet Me In St. Louis (Original Motion Picture Soundtrack)	4:19
All I Do Is Win (feat. T-Pain, Ludacris, Snoop Dogg & Rick Ross)	DJ Khaled	All I Do Is Win (feat. T-Pain, Ludacris, Snoop Dogg & Rick Ross)	3:50
All I Ever Wanted (With Queen's Reprise)	VARIOUS ARTISTS	The Prince Of Egypt (Music From The Original Motion Picture Soundtrack)	2:51
All I Want for Christmas Is You	Mariah Carey	Merry Christmas	4:01
All I've Ever Known	Anaïs Mitchell	Hadestown (Original Broadway Cast Recording)	4:03
All I've Ever Known ("In spite of herself...") [Intro]	Anaïs Mitchell	Hadestown (Original Broadway Cast Recording)	0:40
All In My Head (Flex)	Fifth Harmony	7/27 (Deluxe) [Explicit]	3:30
All Is Found	VARIOUS ARTISTS	Frozen 2 (Original Motion Picture Soundtrack)	2:05
All My Life	Remady & Bonny Lauren	All My Life	2:43
All Night	VARIOUS ARTISTS	P. Advisory, part 1	4:01
All Of This [feat. Robert Smith]	blink-182	blink-182 [Explicit]	4:40
All That Glitters	Earl	Tongue Tied [Explicit]	3:17
All That Really Matters (Stripped Version)	Illenium & Teddy Swims	All That Really Matters (Stripped Version)	3:19
All To Him (Live)	Hillsong Worship	These Same Skies (Live)	7:08
All We Do	Oh Wonder	Oh Wonder	3:34
Almost (Sweet Music)	Hozier	Wasteland, Baby! [Explicit]	3:37
Almost There	VARIOUS ARTISTS	The Princess and the Frog (Original Motion Picture Soundtrack)	2:24
Almost There (From ''The Princess And The Frog'')	VARIOUS ARTISTS	Disney Princess: Fairy Tale Songs	2:24
Alone	Monstercat	Monstercat 027 - Cataclysm	4:33
Alone	Marshmello	Alone	4:33
Always	blink-182	blink-182 [Explicit]	4:11
Amber Jean	Neil Young International Harvesters	A Treasure	3:17
Angels We Have Heard on High	The Piano Guys	A Family Christmas	3:32
Angels We Have Heard On High	Tommee Profitt	The Birth Of A King	3:43
Angry World	Neil Young	Le Noise [+Digital Booklet]	4:12
Animals	Nickelback	All the Right Reasons	3:06
Anita	Armin van Buuren & Timmy Trumpet	Anita	3:00
Another In The Fire (Live)	Hillsong UNITED	People (Live)	6:33
Another Love (Tiësto Remix)	Tom Odell	Another Love (Tiësto Remix)	3:05
Another Sad Love Song	Khalid	American Teen [Explicit]	4:04
Anthem Part Two (Live In Chicago)	blink-182	blink-182 [Explicit]	3:44
Anthony	Nickel Creek	Why Should The Fire Die?	1:55
Any Moment	VARIOUS ARTISTS	Into the Woods (Original Motion Picture Soundtrack)	1:41
Any Moment / Moments in the Woods	Original Broadway Cast of Into the Woods	Into the Woods (Original Broadway Cast Recording)	4:58
Any Way the Wind Blows	Anaïs Mitchell	Hadestown (Original Broadway Cast Recording)	3:45
Anybody Have a Map?	VARIOUS ARTISTS	Dear Evan Hansen (Original Broadway Cast Recording)	2:26
Anyone's Ghost	The National	High Violet (Expanded Edition) [Explicit]	2:54
Anything Could Happen	Ellie Goulding	Halcyon Days	4:46
Apex Predator	Reneé Rapp & Auli'i Cravalho	Mean Girls (Music From The Motion Picture) [Explicit]	3:08
Applause	Lady Gaga	Applause	3:32
Arabian Nights	VARIOUS ARTISTS	Aladdin (Original Motion Picture Soundtrack)	1:19
Arabian Nights	Alan Menken, Aladdin - Cast & Disney	Aladdin Special Edition	1:19
Are You Ready For The Country?	Neil Young International Harvesters	A Treasure	3:38
Are You Ready for the Country? (2009 Remaster)	Neil Young	Harvest (2009 Remaster)	3:23
Aria	VARIOUS ARTISTS	Beauty and the Beast (Original Motion Picture Soundtrack)	1:02
As I Am [feat. Khalid]	Justin Bieber	Justice [Clean]	2:54
As Long As You're Mine (From "Wicked" Original Broadway Cast Recording/2003)	VARIOUS ARTISTS	Wicked	3:46
Ashes	Stellar	Ashes [Explicit]	2:46
Asthenia	blink-182	blink-182 [Explicit]	4:19
Astronaut In The Ocean	Masked Wolf	Astronomical [Explicit]	2:13
Astronaut In The Ocean	Masked Wolf	Astronaut In The Ocean [Explicit]	2:12
At The End Of The Day	Les Misérables Cast	Les Misérables: The Motion Picture Soundtrack Deluxe (Deluxe Edition)	4:26
At The End Of The Day	VARIOUS ARTISTS	Les Misérables (Original Broadway Cast Recording)	4:43
At the End of the Day (Live)	Claude-Michel Schönberg & Alain Boublil	Les Misérables Live! (2010 London Cast Recording)	4:58
At Last	Etta James	Love Songs	3:03
At Last	Etta James	At Last!	3:02
Atlas: Two	Sleeping At Last	Atlas: Two	4:20
Atmosphere	TobyMac	Welcome To Diverse City	4:07
Atmosphere (Remix) [feat. dc Talk]	TobyMac	Welcome To Diverse City	4:37
Attention	Charlie Puth	Attention	3:31
August's Rhapsody	August Rush (Motion Picture Soundtrack)	August Rush (Soundtrack)	7:37
Ave Maria	Winchester Cathedral Choir, Andrew Lumsden & Sarah Baldock, organist	Advent in Winchester "O Come Emmanuel"	5:14
Away In A Manger	Tommee Profitt	The Birth Of A King	5:39
Away in a Manger	The Piano Guys	A Family Christmas	3:09
Awesome God	Rich Mullins	Songs	3:03
Bach / Break	August Rush (Motion Picture Soundtrack)	August Rush (Soundtrack)	3:50
Back To Black	Amy Winehouse	Back To Black [Explicit]	4:00
Back To Life (Live)	Bethel Music	Homecoming (Live)	6:35
Back to the Palace (Bonus Track)	Original Broadway Cast of Into the Woods	Into the Woods (Original Broadway Cast Recording)	2:31
Back To You	Selena Gomez, OneRepublic & YUNGBLUD	13 Reasons Why (Season 2) [Explicit]	3:30
Back To You	Lost Frequencies	All Stand Together	2:37
BACKBONE	Droeloe & Nevve	BACKBONE [Explicit]	3:21
Backseat Driver [feat. Hollyn & Tru]	TobyMac	This Is Not A Test (Deluxe Edition)	3:21
Bad At Love	Halsey	hopeless fountain kingdom (Deluxe Plus) [Clean]	3:01
Bad Blood	Taylor Swift	1989	3:31
Bad Decisions	Ariana Grande	Dangerous Woman [Explicit]	3:46
bad guy	Billie Eilish	WHEN WE ALL FALL ASLEEP, WHERE DO WE GO?	3:14
Bad Kind of Butterflies	Camila Cabello	Romance [Explicit]	2:49
Bad Memories [feat. Elley Duhé & FAST BOY]	Meduza & James Carter [feat. Elley Duhé & Fast Boy]	Bad Memories	2:29
Bad Things	Machine Gun Kelly	bloom (Deluxe) [Clean]	3:59
La Bamba (Album Version)	August Rush (Motion Picture Soundtrack)	August Rush (Soundtrack)	3:45
Bane	alt-J	The Dream [Explicit]	5:10
Bang Bang	Jessie J	Sweet Talker	3:19
Bang Bang	VARIOUS ARTISTS	Pitch Perfect 2 - Special Edition (Original Motion Picture Soundtrack)	3:19
Bang Bang	Ariana Grande	My Everything (Deluxe)	3:19
Bang!	AJR	OK ORCHESTRA [Explicit]	2:50
The Banjo Beat, Pt. 1	Ricky Desktop	The Banjo Beat, Pt. 1	1:12
A Bar Song (Tipsy)	Shaboozey	A Bar Song (Tipsy) [Explicit]	2:51
The Bargain	Les Misérables Cast	Les Misérables: The Motion Picture Soundtrack Deluxe (Deluxe Edition)	3:24
Bari Improv	August Rush (Motion Picture Soundtrack)	August Rush (Soundtrack)	1:35
Bastards	Kesha	Rainbow [Explicit]	3:51
Battle Belongs	Phil Wickham	Battle Belongs	4:47
Battle Scars (with Guy Sebastian)	Lupe Fiasco	Food & Liquor II: The Great American Rap Album, Pt. 1 [Explicit]	4:10
Be A Light [feat. Reba McEntire & Hillary Scott & Chris Tomlin & Keith Urban]	VARIOUS ARTISTS	Discover More Country	2:54
Be My Escape	Relient K	Mmhmm	4:00
Be Okay	Lauren Daigle	Lauren Daigle	3:29
Beautiful	Andrew Lloyd Webber	Love Never Dies	3:32
Beautiful	VARIOUS ARTISTS	Heathers: The Musical (World Premiere Cast Recording) [Explicit]	8:19
Beautiful Mistakes	Maroon 5	JORDI [Explicit]	3:47
Beautiful Things	Gungor	Beautiful Things	5:10
Beautiful Things	Benson Boone	Beautiful Things	3:00
Bed Head	Joey Pecoraro	Deep in a Dream of You	2:16
Beep [feat. will.i.am]	The Pussycat Dolls	PCD	3:49
Before You Go	Lewis Capaldi	Divinely Uninspired To A Hellish Extent (Extended Edition) [Explicit]	3:35
Beggars At The Feast	Les Misérables Cast	Les Misérables: The Motion Picture Soundtrack Deluxe (Deluxe Edition)	0:29
Beggin'	Chris Lake & Aluna	Beggin'	3:03
Behold a Pale Horse	Stoik [feat. Jah'kota, Plex & Drezus]	Behold a Pale Horse	4:22
Believe For It	CeCe Winans	Believe For It	3:48
Believe For It (Live)	CeCe Winans	Believe For It	8:22
Bella Ciao	Hardwell & Maddix	Bella Ciao	3:23
The Bells Of Notre Dame	VARIOUS ARTISTS	The Hunchback of Notre Dame (Studio Cast Recording)	7:27
The Bells of Notre Dame (From "The Hunchback of Notre Dame"/Soundtrack)	VARIOUS ARTISTS	Disney's Greatest Volume 2	6:25
Belly Dancer	Imanbek & BYOR	Belly Dancer	2:31
bellyache	Billie Eilish	dont smile at me	2:59
Beneath A Moonless Sky	Andrew Lloyd Webber	Love Never Dies	7:33
Benny's Dispatch	In The Heights (Original Cast Recording)	In The Heights	2:15
Best Friend	VARIOUS ARTISTS	NOW That's What I Call Music, Vol. 65 [Clean]	3:02
Best Of Luck	Nickel Creek	Why Should The Fire Die?	3:22
Best of Wives and Best of Women	Lin-Manuel Miranda	Hamilton (Original Broadway Cast Recording) [Explicit]	0:47
Better in Color	Lizzo	Cuz I Love You (Deluxe) [Explicit]	2:13
Between Two Lungs	Florence + The Machine	Lungs	4:09
Beyond Me	TobyMac	This Is Not A Test (Deluxe Edition)	3:13
Beyond Me (Phenomenon Remix By Soul Glow Activatur)	TobyMac	This Is Not A Test (Deluxe Edition)	3:47
Beyond the Sea	Bobby Darin	The Ultimate Bobby Darin	2:52
Big Parade	The Lumineers	The Lumineers	5:27
Big Time	Big & Rich	Horse of a Different Color	3:56
Birthday Suit	Cosmo Sheldrake	The Much Much How How and I	1:20
The Bishop	Les Misérables Cast	Les Misérables: The Motion Picture Soundtrack Deluxe (Deluxe Edition)	1:34
Black Betty	Ram Jam	The Very Best Of Ram Jam	3:57
Black Mambo	Glass Animals	ZABA [Explicit]	4:08
Black Man In A White World	Michael Kiwanuka	Love & Hate	4:19
Black Sheep (Brie Larson Vocal Version / Bonus Track) [feat. Brie Larson]	VARIOUS ARTISTS	Scott Pilgrim Vs. The World (Original Motion Picture Soundtrack Expanded Edition)	4:54
Black Wedding (feat. Rob Halford)	In This Moment	Ritual [Explicit]	4:07
Black Widow [feat. Rita Ora]	Iggy Azalea	The New Classic (Deluxe Version) [Clean]	3:29
Blackout	Lin-Manuel Miranda	In the Heights (Original Broadway Cast Recording)	3:57
Blah Blah Blah	VARIOUS ARTISTS	Armada 15 Years (Deluxe Edition)	3:04
The Blessing (Live)	Kari Jobe, Cody Carnes & Elevation Worship	The Blessing (Live)	8:34
Blessings	Hollow Coves	Blessings	4:10
Blinding	Florence + The Machine	Lungs	4:40
The Blood	Naomi Raine	Back to Eden Pt. II	7:59
The Blood Reprise	Naomi Raine	Back to Eden Pt. II	15:06
Blow Us All Away	Lin-Manuel Miranda	Hamilton (Original Broadway Cast Recording) [Explicit]	2:53
Blown Away	Hillsong UNITED	Are We There Yet?	6:06
blue	Christina Perri	a lighter shade of blue	3:34
Blue	Ed Sheeran	Autumn Variations [Explicit]	2:34
Blue (Flume Remix)	Eiffel 65	Blue (Flume Remix)	2:47
Blue Skies	Ella Fitzgerald	Pure Ella	3:44
Blue Skies (Maya Jane Coles Remix)	VARIOUS ARTISTS	Verve Remixed: The First Ladies	5:37
Blue Skies (Remastered)	Bobby Darin	Great Gentlemen Of Song / Spotlight On Bobby Darin	2:34
Blueberry Faygo	Lil Mosey	Certified Hitmaker [Explicit]	2:42
Body	Russ Millions & Tion Wayne	Body [Explicit]	3:03
bodyache	Purity Ring	another eternity	2:53
Bohemian Like You	The Dandy Warhols	Thirteen Tales From Urban Bohemia	3:32
Bohemian Rhapsody (Remastered 2011)	Queen	A Night At The Opera	5:54
Bones	Imagine Dragons	Bones	2:45
Bones in the Ocean	The Longest Johns	Bones in the Ocean	3:13
Boogie Feet	Kesha	Rainbow [Explicit]	2:53
BOOM	X Ambassadors	BOOM	2:43
BOOM [feat. Gucci Mane]	Tiësto & Sevenn [feat. Gucci Mane]	BOOM [Explicit]	3:00
Boom Crunch (Bonus Track)	Original Broadway Cast of Into the Woods	Into the Woods (Original Broadway Cast Recording)	2:36
Boots	Kesha	Rainbow [Explicit]	3:03
Booty [feat. Iggy Azalea]	Jennifer Lopez [feat. Iggy Azalea]	Booty	3:29
Booty Swing	Parov Stelar	The Paris Swing Box	3:16
Born For This	The Score	Pressure [Explicit]	3:54
Bottom Of The Deep Blue Sea	MISSIO	Loner [Explicit]	3:51
Bottom of the River	Delta Rae	Carry the Fire	3:22
Bound For Glory	Neil Young International Harvesters	A Treasure	5:57
The Boy Next Door	VARIOUS ARTISTS	Meet Me In St. Louis (Original Motion Picture Soundtrack)	3:28
Boyfriend	Dove Cameron	Boyfriend [Explicit]	2:33
Boys	Lizzo	Cuz I Love You (Deluxe) [Explicit]	2:52
Boys And Girls Like You and Me (Outtake)	VARIOUS ARTISTS	Meet Me In St. Louis (Original Motion Picture Soundtrack)	2:17
Brass Devil	Parov Stelar	Voodoo Sonic (The Album)	3:52
Break Free [feat. Zedd]	Ariana Grande	My Everything (Deluxe)	3:34
Break My Face	AJR	Neotheater [Explicit]	3:46
Break My Heart (arr. string quartet) (Inspired by ‘Bridgerton’)	Music Lab Collective	Break My Heart (arr. string quartet) (Inspired by ‘Bridgerton’)	3:36
Breakin' Dishes	Rihanna	Good Girl Gone Bad: Reloaded	3:20
Breath Of Heaven (Mary's Song)	Amy Grant	Home For Christmas	5:30
Breathe	In The Heights (Original Cast Recording)	In The Heights	4:01
Breathless (Radio Edit)	Cascada	Evacuate The Dancefloor	3:10
Breezeblocks	alt-J	An Awesome Wave	3:47
Brighter Day	Gungor	Beautiful Things	3:57
Bring Him Home	Les Misérables Cast	Les Misérables: The Motion Picture Soundtrack Deluxe (Deluxe Edition)	3:37
Broken [feat. Amy Lee]	Seether	Disclaimer II [Explicit]	4:18
Broken Arrow (2017 Remaster)	Neil Young	Decade	6:14
Broken Vessels (Amazing Grace) (Live)	Hillsong Worship	No Other Name (Live)	9:28
Brokenness Aside	All Sons & Daughters	Season One	5:52
The Brunch Bunch	VARIOUS ARTISTS	Kipo And The Age Of Wonderbeasts (Season 3 Mixtape)	1:18
Budapest	George Ezra	Did You Hear the Rain?	3:22
Build My Life	Housefires	Housefires III	8:12
Building The Barricade	Les Misérables Cast	Les Misérables: The Motion Picture Soundtrack Deluxe (Deluxe Edition)	1:43
Bulletproof [feat. XYLØ]	The Score [feat. XYLØ]	Bulletproof	3:10
Buona Sera (Remastered)	Sam Butera & The Witnesses, Keely Smith & Louis Prima	Capitol Collectors Series	3:07
Burn	Lin-Manuel Miranda	Hamilton (Original Broadway Cast Recording) [Explicit]	3:45
Burn For You	TobyMac	Welcome To Diverse City	3:49
Burn The House Down	AJR	The Click (Deluxe Edition) [Explicit]	3:32
Burn Slow	Jaira Burns	Burn Slow [Explicit]	3:12
Burned (2017 Remaster)	Neil Young	Decade	2:16
The Business, Pt. II	Tiësto & Ty Dolla $ign	The Business, Pt. II	2:44
By Our Love	VARIOUS ARTISTS	A.D. The Bible Continues: Music Inspired By The Epic NBC Television Event	3:18
Bye Bye Blackbird	Sarah Vaughan	Live In Japan Vol 2	7:41
Cabinet Battle #1	Lin-Manuel Miranda	Hamilton (Original Broadway Cast Recording) [Explicit]	3:35
Cabinet Battle #2	Lin-Manuel Miranda	Hamilton (Original Broadway Cast Recording) [Explicit]	2:22
Cages	We The Kingdom	Holy Water	3:35
Cake by the Ocean (From "Hotel Transylvania 3")	VARIOUS ARTISTS	Kids Movie Songs 2018	3:40
California [with Big & Rich]	Tim McGraw	Damn Country Music (Deluxe Edition)	3:25
Call It Love	Felix Jaehn & Ray Dalton	Call It Love	2:35
Call Me Out	Gungor	Beautiful Things	3:01
Call Me When You're Sober	Evanescence	The Open Door	3:35
Call You Mine (Lookas Remix)	The Chainsmokers & Bebe Rexha	Call You Mine (Remixes)	3:46
Campaigner	Neil Young	Songs for Judy	3:30
Can't Complain	Nickel Creek	Why Should The Fire Die?	5:34
Can't Find My Way Home	Blind Faith	Blind Faith	3:16
Can't Help Falling In Love	Elvis Presley	Elvis 30 #1 Hits	2:57
Can't Help Falling in Love - Single	Haley Reinhart	Can't Help Falling in Love - Single	2:53
Can't Lose More	Carpetman	Can't Lose More [Explicit]	3:01
Can't You See	The Marshall Tucker Band	The Marshall Tucker Band	6:05
Candy Shop X Element (Remix)	Eduardo Luzquiños	Viral Hits TikTok (Remix)	1:49
Cane Shuga	Glass Animals	How To Be A Human Being [Explicit]	3:16
Cannot Keep You	Gungor	Beautiful Things	4:01
Canvas of Life	Epica	The Quantum Enigma	5:28
Careful My Toe	VARIOUS ARTISTS	Into the Woods (Original Motion Picture Soundtrack)	1:10
carmen	Stromae	Racine Carrée (Standard US Version) [Explicit]	3:09
Carnaval Del Barrio	Lin-Manuel Miranda	In the Heights (Original Broadway Cast Recording)	7:26
Carol Of The Bells	Percy Faith	Music Of Christmas Volume II [Clean]	2:14
Carol Of The Bells	The Tabernacle Choir at Temple Square	Joy to the World	2:27
Carol of the Bells	Pentatonix	PTXmas (Deluxe Edition)	3:13
Carol Of The Bells	Lindsey Stirling	Warmer In The Winter	2:46
Carol of the Bells	John Williams	Home Alone (Original Motion Picture Soundtrack) (Anniversary Edition)	1:25
Carol of the Bells (Choral)	Carol of the Bells	Carol of the Bells	1:26
Carol of the Bells / God Rest Ye Merry Gentlemen	The Piano Guys	A Family Christmas	3:21
Carol Of The Bells / Sing We Now Of Christmas	BarlowGirl	Home For Christmas	4:00
Castle	Halsey	BADLANDS (Deluxe) [Explicit]	4:37
CASTLE OF GLASS	Linkin Park	LIVING THINGS	3:25
Castle On A Cloud	VARIOUS ARTISTS	Les Misérables (Original Broadway Cast Recording)	1:40
Castle On A Cloud	Les Misérables Cast	Les Misérables: The Motion Picture Soundtrack Deluxe (Deluxe Edition)	1:11
Catch Me	VARIOUS ARTISTS	Kipo And The Age Of Wonderbeasts (Season 3 Mixtape)	0:46
Catchafire (Whoopsi-Daisy)	TobyMac	Welcome To Diverse City	3:24
Caught up in the Moment	Big & Rich	Comin' to Your City	3:42
Cavatina	2Cellos	Score	3:43
The Chain (2004 Remaster)	Fleetwood Mac	Rumours	4:29
Chains	Nick Jonas	Nick Jonas (Deluxe) [Explicit]	3:23
Chalk Outlines	Ren & Chinchilla	Chalk Outlines	3:54
Champagne	Lin-Manuel Miranda	In the Heights (Original Broadway Cast Recording)	2:43
Champion (Live)	Bethel Music	Revival's In The Air (Live)	8:47
Change	NF	The Search	3:54
Chant	Anaïs Mitchell	Hadestown (Original Broadway Cast Recording)	6:31
Chant (Reprise)	Anaïs Mitchell	Hadestown (Original Broadway Cast Recording)	4:01
Chapstick	Coin	Chapstick	3:13
Charlie Boy	The Lumineers	The Lumineers	4:21
Chasing Cars	Snow Patrol	Greatest Hits	4:26
cheers	blackbear [feat. Wiz Khalifa]	cheers	3:21
Cheers (Drink to That)	Walk Off the Earth	Vol. 1	3:05
Chevre Sisters	VARIOUS ARTISTS	Kipo And The Age Of Wonderbeasts (Season 2 Mixtape)	1:44
Chicago	alt-J	The Dream [Explicit]	3:55
Chim Chim Cher-ee (From "Mary Poppins"/Soundtrack Version)	VARIOUS ARTISTS	Mary Poppins	2:46
Chop Suey!	System Of A Down	Toxicity	3:30
Chopin: 12 Études, Op. 10: No. 12 in C Minor "Revolutionary"	Vladimir Ashkenazy & Frédéric Chopin	Chopin: Favourite Piano Works	2:47
Christmas Dinner, Country Style (Remastered 2006)	Bing Crosby	Bing Crosby - Christmas Classics	2:29
Christmas Medley	Jon Schmidt	Jon Schmidt Christmas	5:25
Christmas Morning	The Piano Guys	A Family Christmas	3:58
Christmas Present	Doris Day	The Doris Day Christmas Album	2:51
Christmas Story	Doris Day	Personal Christmas Collection	3:08
The Christmas Waltz	Doris Day	The Doris Day Christmas Album	2:51
Christmas With You	Spencer Day	Christmas With You (feat. The Joel Evans Big Band) - Single	3:38
Church Bells	Carrie Underwood	Storyteller	3:14
Cinderella At The Grave	Original Broadway Cast of Into the Woods	Into the Woods (Original Broadway Cast Recording)	1:13
Cinderella at the Grave	VARIOUS ARTISTS	Into the Woods (Original Motion Picture Soundtrack)	1:40
Cinema Paradiso	2Cellos	Score	3:59
Cinnamon Girl (2009 Remaster)	Neil Young & Crazy Horse	Everybody Knows This Is Nowhere	3:00
Circles	Post Malone	The Diamond Collection (Deluxe) [Explicit]	3:35
CITY OF ANGELS	24kgoldn	DROPPED OUTTA COLLEGE [Explicit]	1:52
City Of Stars	Justin Hurwitz, Justin Paul & Benj Pasek	La La Land (Original Motion Picture Soundtrack)	1:51
City Of Stars (From "La La Land" Soundtrack)	Justin Hurwitz, Justin Paul & Benj Pasek	La La Land (Original Motion Picture Soundtrack)	2:29
Claire de Lune-Claude Debussy	Susie Tallman	Classical Baby	5:46
Classy Girls	The Lumineers	The Lumineers	2:45
Clementine	Neil Young & Crazy Horse	Americana [+video]	5:40
Closer	The Chainsmokers [feat. Halsey]	Closer	4:05
Closer to the Sun	Slightly Stoopid	Closer To The Sun	2:25
CLOUDS	NF	CLOUDS (THE MIXTAPE)	4:03
CLOUDS (Edit)	NF	CLOUDS (THE MIXTAPE)	3:49
The Club	Lin-Manuel Miranda	In the Heights (Original Broadway Cast Recording)	5:58
Coastline	Hollow Coves	Wanderlust	3:54
Cocoa Hooves	Glass Animals	ZABA [Explicit]	4:31
Coffee	Sylvan Esso	Sylvan Esso	4:28
Cold (Acoustic)	Flawed Mangoes	Cold (Acoustic)	3:02
Colors	Halsey	BADLANDS (Deluxe) [Explicit]	4:10
Colors	Łaszewo	Colors	3:35
Colors	Black Pumas	Black Pumas	4:06
Colors of the Wind	VARIOUS ARTISTS	Pocahontas	3:34
Come & Get It	Selena Gomez	Stars Dance (Amazon Exclusive)	3:52
Come Alive	VARIOUS ARTISTS	The Greatest Showman (Original Motion Picture Soundtrack)	3:45
Come Alive (Dry Bones)	Lauren Daigle	How Can It Be (Deluxe Edition)	3:55
Come Along	Pentatonix	Come Along	3:00
Come and Get Your Love (Rerecorded)	Redbone	The Best of Redbone	3:28
Come And Play (Masquerade)	VARIOUS ARTISTS	Eurovision Song Contest: The Story of Fire Saga (Music from the Netflix Film)	3:08
Come Away To The Water (feat. Maroon 5 & Rozzi Crane)	VARIOUS ARTISTS	The Hunger Games: Songs From District 12 And Beyond	5:13
Come Home with Me	Anaïs Mitchell	Hadestown (Original Broadway Cast Recording)	1:47
Come Home with Me (Reprise)	Anaïs Mitchell	Hadestown (Original Broadway Cast Recording)	1:01
Comin' Home Baby	VARIOUS ARTISTS	Atlantic Top 60: Jazz, Jive and Strut	2:43
Comin' to Your City	Big & Rich	Comin' to Your City	3:27
Coming Back	Mitch King	A Life Under the Sun	5:08
The Concerto	Arcane & League of Legends	Arcane League of Legends (Original Score from Act 2 of the Animated Series)	2:26
Confess	Apashe, LeKtriQue	Confess	5:21
Confident	Demi Lovato	Confident (Deluxe Edition) [Clean]	3:25
The Confrontation	Les Misérables Cast	Les Misérables: The Motion Picture Soundtrack Deluxe (Deluxe Edition)	1:55
The Conqueror's Waltz	Joshua Kyan Aalampour	The Conqueror's Waltz	1:40
Control	Halsey	BADLANDS (Deluxe) [Explicit]	3:34
The Convent	Les Misérables Cast	Les Misérables: The Motion Picture Soundtrack Deluxe (Deluxe Edition)	0:52
Conversation	Lounge Lizard Publications Limited	Learn Italian Words	7:15
Cool for the Summer	Demi Lovato	Confident (Deluxe Edition) [Explicit]	3:34
Cool Kids	Echosmith	Talking Dreams	3:35
COPYCAT	Billie Eilish	dont smile at me	3:14
Cortez the Killer (2017 Remaster)	Neil Young	Decade	7:32
Cosmic Love	Florence + The Machine	Lungs	4:15
Cough Syrup	Young The Giant	Young The Giant	4:09
Could I Be	Sylvan Esso	Sylvan Esso	4:39
Cowboy Casanova	Carrie Underwood	Greatest Hits: Decade #1	3:56
Cowgirl in the Sand (2009 Remaster)	Neil Young & Crazy Horse	Everybody Knows This Is Nowhere	10:06
Coyote	Dope Lemon	Honey Bones [Explicit]	3:49
Cozy	Jeremy Zucker, Lauv & Alexander 23	Cozy	2:45
Crank It Up (Feat. Akon)	David Guetta	Nothing but the Beat [Explicit]	3:12
Crash My Car	Coin	Dreamland	3:08
Crave You (Adventure Club Remix)	VARIOUS ARTISTS	Ultra Dance 14	3:53
Crazy In Love	Beyoncé	Dangerously In Love	3:56
Crazy In Love (Remix)	Beyoncé	Crazy In Love (Remix)	3:46
Creation Sings (feat. Leslie Jordan & David Leonard)	All Sons & Daughters [feat. Leslie Jordan & David Leonard]	Poets & Saints (feat. Leslie Jordan & David Leonard)	3:51
Creator	The Lads	Secrets of the Universe	3:32
creature	half·alive	Now, Not Yet	5:35
Creatures in Heaven	Glass Animals	I Love You So F***ing Much [Explicit]	3:42
Creep	R3HAB & GATTÜSO	Creep (mint Singles) [Explicit]	2:41
Cringe	Matt Maeson	Who Killed Matt Maeson	3:35
Crooked Frame	VARIOUS ARTISTS	Por Vida: A Tribute to the Songs of Alejandro Escovedo	3:59
Cruel To The Beat	VARIOUS ARTISTS	Kipo And The Age Of Wonderbeasts (Season 3 Mixtape)	1:42
Crybaby	Lizzo	Cuz I Love You (Deluxe) [Explicit]	2:55
CTRL + ALT + DEL	Rêve	CTRL + ALT + DEL	2:33
CTRL + ALT + DEL	Rêve	CTRL + ALT + DEL (12" Mix)	2:33
Cuba Libre	Parov Stelar	The Burning Spider	3:13
The Cure	Lady Gaga	The Cure	3:31
The Cure	VARIOUS ARTISTS	Kipo And The Age Of Wonderbeasts (Season 3 Mixtape)	1:30
Curses	The Crane Wives	Foxlore	3:49
Cuz I Love You	Lizzo	Cuz I Love You (Deluxe) [Clean]	3:01
Cuz I Love You	Lizzo	Cuz I Love You (Deluxe) [Explicit]	3:00
Cyclone	Baby Bash	Cyclone	3:57
Dance Monkey	Tones And I	Dance Monkey	3:29
Dance of the Sugar Plum Fairy	Pentatonix	The Best Of Pentatonix Christmas	2:07
Dancing In The Dark	Imagine Dragons	Evolve	3:53
Dancing In The Moonlight (feat. NEIMY)	Jubël [feat. NEIMY]	Dancing In The Moonlight (feat. NEIMY)	2:44
Dancing on the Waves	Bethel Music	Peace	6:16
Dancing Through Life (From "Wicked" Original Broadway Cast Recording/2003)	VARIOUS ARTISTS	Wicked	7:37
Dancing With The Devil	Demi Lovato	Dancing With The Devil…The Art of Starting Over [Explicit]	4:04
Dancing With Your Ghost	Sasha Alex Sloan	Self Portrait [Explicit]	3:18
Dangerous	Cascada	3D (Special Edition)	2:59
Dangerous (feat. Sam Martin)	David Guetta	Dangerous (feat. Sam Martin)	3:23
Dangerous (Oliver Remix)	Big Data	1.6	4:38
Dangerous Woman	Ariana Grande	Dangerous Woman [Clean]	3:55
Danke Schoen	Wayne Newton	Capitol Collectors Series	2:36
Danke Schoen	Wayne Newton	Danke Schoen	2:35
Danke Schoen (Remastered)	VARIOUS ARTISTS	Ultra-Lounge: Wild, Cool & Swingin'  Volume Five	2:35
Dark Side	Bishop Briggs	Bishop Briggs	3:28
Darkside	Alan Walker, Au/Ra & Tomine Harket	Darkside	3:31
DARKSIDE	NEONI	DARKSIDE	2:48
Darkside (feat. Kiiara)	VARIOUS ARTISTS	Bright: The Album [Explicit]	3:53
Davy Jones	Hans Zimmer	Pirates of the Caribbean:  Dead Man's Chest (Original Motion Picture Soundtrack)	3:15
Days In The Sun	VARIOUS ARTISTS	Beauty and the Beast (Original Motion Picture Soundtrack)	2:40
Dead And Gone [feat. Justin Timberlake]	VARIOUS ARTISTS	NOW That's What I Call Music 29, 30, 31	3:53
Dead Girl Walking	VARIOUS ARTISTS	Heathers: The Musical (World Premiere Cast Recording) [Explicit]	3:24
Dead Girl Walking (Reprise)	VARIOUS ARTISTS	Heathers: The Musical (World Premiere Cast Recording) [Explicit]	2:46
Dead Sea	The Lumineers	The Lumineers	4:07
The Deal (No Deal)	VARIOUS ARTISTS	Chess In Concert	10:13
Dear Mr. Fantasy	Steve Winwood	Revolutions: The Very Best Of Steve Winwood	5:37
Dear Old Friend	Andrew Lloyd Webber	Love Never Dies	6:12
Dear Old Shiz (From "Wicked" Original Broadway Cast Recording/2003)	VARIOUS ARTISTS	Wicked	1:26
Dear Theodosia	Lin-Manuel Miranda	Hamilton (Original Broadway Cast Recording) [Explicit]	3:04
death bed (coffee for your head)	Powfu & beabadoobee	death bed (coffee for your head)	2:53
Death of a Bachelor	Panic! At The Disco	Death of a Bachelor [Explicit]	3:23
The Death Of Gavroche	Les Misérables Cast	Les Misérables: The Motion Picture Soundtrack Deluxe (Deluxe Edition)	2:45
Deathstalker Territory	VARIOUS ARTISTS	Kipo And The Age Of Wonderbeasts (Season 2 Mixtape)	1:20
Deep Forbidden Lake (2017 Remaster)	Neil Young	Decade	3:45
Deep Purple	Peter Mintun	DEEP PURPLE and Other Piano Solos from the 1920s and 1930s	5:18
Defender	Francesca Battistelli	Own It	7:04
Defying Gravity (From "Wicked" Original Broadway Cast Recording/2003)	VARIOUS ARTISTS	Wicked	5:53
Deliver Us	VARIOUS ARTISTS	The Prince Of Egypt (Music From The Original Motion Picture Soundtrack)	7:17
Delta	alt-J	The Dream [Explicit]	1:00
Dernière danse (Techno Mix)	Indila & BENNETT	Dernière danse (Techno Mix)	3:17
Desert Night	RÜFÜS DU SOL	Atlas	5:24
Despacito	Luis Fonsi [feat. Daddy Yankee]	Despacito	3:48
Despacito (Remix) [feat. Justin Bieber]	VARIOUS ARTISTS	Summer Latin Hits 2017	3:50
Devil	Two Feet	Devil [Explicit]	2:40
Devil Take The Hindmost	Andrew Lloyd Webber	Love Never Dies	3:51
Devil Take The Hindmost (Quartet)	Andrew Lloyd Webber	Love Never Dies	2:55
The Devil Went Down to Georgia	The Charlie Daniels Band	A Decade Of Hits	3:34
Devil’s Backbone	The Civil Wars	The Civil Wars	2:29
Didn't I	Kelly Clarkson	Meaning of Life	3:38
Dirty	Jessie Murph & Teddy Swims	Dirty [Explicit]	2:53
Disappear	VARIOUS ARTISTS	Dear Evan Hansen (Original Broadway Cast Recording)	4:35
Dissolve (acoustic)	Absofacto	Dissolve (acoustic)	2:48
Dissolve Me	alt-J	An Awesome Wave	3:59
Diverse City	TobyMac	Welcome To Diverse City	3:56
DNA	The Piano Guys	Limitless	3:05
Do I Wanna Know?	Arctic Monkeys	AM	4:32
Do It Again	Elevation Worship	There Is a Cloud	6:38
Do It To It [feat. Cherish]	Acraze [feat. Cherish]	Do It To It	2:38
Do It To It (Tiësto Remix) [feat. Cherish & Tiësto]	Acraze [feat. Cherish & Tiësto]	Do It To It (Tiësto Remix)	2:05
Do You Hear The People Sing?	Les Misérables Cast	Les Misérables: The Motion Picture Soundtrack Deluxe (Deluxe Edition)	2:03
Do You Hear That? / I Wonder (From "Sleeping Beauty"/Soundtrack Version)	VARIOUS ARTISTS	Sleeping Beauty	3:57
Do You Hear What I Hear? (Remastered 2006)	Bing Crosby	Bing Crosby - Christmas Classics	2:45
Do You Know	TobyMac	Momentum	3:55
The Docks (Lovely Ladies)	Les Misérables Cast	Les Misérables: The Motion Picture Soundtrack Deluxe (Deluxe Edition)	4:03
Dog Days Are Over	Florence + The Machine	Lungs	4:12
Doin' Time	Lana Del Rey	Norman Fucking Rockwell! [Explicit]	3:22
Domestic Bliss	Glass Animals	Dreamland [Explicit]	3:18
Don't Bring Me Down (Interlude)	TobyMac	Momentum	2:02
Don't Cha (Radio Edit)	The Pussycat Dolls	Don't Cha	4:02
Don't Fence Me In	Labrinth	Don't Fence Me In	2:49
Don't Forget About Me	VARIOUS ARTISTS	Me Before You (Original Motion Picture Soundtrack)	4:29
Don't Let Me Down	The Chainsmokers	Collage EP	3:28
DON'T LOOK DOWN (Manila Killa Remix)	San Holo [feat. Lizzy Land]	DON'T LOOK DOWN (feat. Lizzy Land) [Remixes]	2:52
Don't Stop Now	VARIOUS ARTISTS	Kipo And The Age Of Wonderbeasts (Season 1 Mixtape) [Clean]	2:07
Don't Tread On Me	We The Kingdom	Don't Tread On Me	3:59
Don't Worry, Be Happy (From "Hotel Transylvania 3")	VARIOUS ARTISTS	Kids Movie Songs 2018	3:47
Don't You Wanna Stay (with Kelly Clarkson)	Jason Aldean	My Kinda Party	4:16
Don’t Blame Me	Taylor Swift	reputation	3:56
DONTTRUSTME	3OH!3	WANT [Explicit]	3:12
Doses & Mimosas	Cherub	Year of the Caprese [Explicit]	5:23
Double Trouble (Film Version)	VARIOUS ARTISTS	Eurovision Song Contest: The Story of Fire Saga (Music from the Netflix Film)	2:54
Double Trouble (Tiësto's Euro 90s Tribute Remix)	VARIOUS ARTISTS	Eurovision Song Contest: The Story of Fire Saga (Music from the Netflix Film)	2:28
Doubt Comes In	Anaïs Mitchell	Hadestown (Original Broadway Cast Recording)	4:51
Doubting Thomas	Nickel Creek	Why Should The Fire Die?	3:19
Down	blink-182	blink-182 [Explicit]	3:03
Down	Jason Walker	Jason Walker	4:05
Down by the River (2017 Remaster)	Neil Young	Decade	9:20
Down in New Orleans (Finale)	VARIOUS ARTISTS	The Princess and the Frog (Original Motion Picture Soundtrack)	1:35
Down to the Wire (2017 Remaster)	Neil Young	Decade	2:31
Down With Humans	VARIOUS ARTISTS	Kipo And The Age Of Wonderbeasts (Season 2 Mixtape)	1:28
Downtown	Majical Cloudz	Are You Alone?	4:09
Draw the Line (Yanou's Candlelight Mix)	Cascada	Evacuate The Dancefloor	3:55
Dream A Little Dream Of Me (Single Version)	Louis Armstrong & Ella Fitzgerald	Ella & Louis For Lovers (Deluxe Edition)	3:08
Dream Ballet	VARIOUS ARTISTS	Oklahoma! (2019 Broadway Cast Recording)	9:13
A Dream Is a Wish Your Heart Makes (From "Cinderella" / Soundtrack Version)	VARIOUS ARTISTS	Cinderella	4:34
Dream A Little Dream Of Me	The Mamas & The Papas	Greatest Hits: The Mamas & The Papas	3:14
Dream A Little Dream Of Me	Ella Fitzgerald & Louis Armstrong	Cheek To Cheek: The Complete Duet Recordings	3:08
Dreamin' Man	Neil Young	Harvest Moon	4:36
Dreamland	Glass Animals	Dreamland [Explicit]	3:23
DRIFTING	NF	CLOUDS (THE MIXTAPE)	3:20
Drink to That All Night	Jerrod Niemann	High Noon	3:45
Drink With Me	Les Misérables Cast	Les Misérables: The Motion Picture Soundtrack Deluxe (Deluxe Edition)	1:42
Drop The Game	VARIOUS ARTISTS	TheSoundYouNeed, Vol. 1	3:42
Drop the Game	The Dartmouth Aires	Wayfairer - EP	3:13
Drop It	Tujamo & Lukas Vane	Drop It	2:55
Drowning	VARIOUS ARTISTS	Kipo And The Age Of Wonderbeasts (Season 3 Mixtape)	1:21
The Drug In Me Is Reimagined	Falling In Reverse	The Drug In Me Is Reimagined [Explicit]	5:40
The Drug In Me Is You	Falling In Reverse	The Drug In Me Is You [Explicit]	3:38
DRUM GO DUM x POPSTARS (dennis marcus mashup)	Dennis Marcus	Next Stop 다음역	3:12
Drumming Song	Florence + The Machine	Lungs	3:43
Dry Bones	Gungor	Beautiful Things	5:16
Dueling Guitars (Album Version)	August Rush (Motion Picture Soundtrack)	August Rush (Soundtrack)	2:34
dying on the inside	Nessa Barrett	dying on the inside [Explicit]	3:24
The Earth Is Yours	Gungor	Beautiful Things	3:08
Earth Song	Seraphic Fire	Reincarnations: A Century of American Choral Music	3:42
Earth Song	David Garrett	Rock Revolution (Deluxe)	4:05
Eastside	benny blanco	FRIENDS KEEP SECRETS [Explicit]	2:51
Easy Target	blink-182	blink-182 [Explicit]	2:20
Edge of the Blade	Epica	The Holographic Principle	4:34
Eee-o Eleven	VARIOUS ARTISTS	The Legends of Music	2:41
Einaudi: Experience	Ludovico Einaudi	In A Time Lapse (Deluxe Edition)	5:15
Einaudi: Nuvole Bianche	Ludovico Einaudi	Islands - Essential Einaudi (Deluxe Version)	5:58
Einaudi: Una Mattina	Ludovico Einaudi	Una Mattina	3:24
The Election of 1800	Lin-Manuel Miranda	Hamilton (Original Broadway Cast Recording) [Explicit]	3:58
Electric Love	BØRNS	Dopamine	3:38
Elgar / Something Inside (Album Version)	August Rush (Motion Picture Soundtrack)	August Rush (Soundtrack)	4:50
Emmanuel	Amy Grant	A Christmas Album	2:53
Emmanuel, God With Us	Amy Grant	Home For Christmas	4:57
Empire Now	Hozier	Unheard	2:58
Empty Chairs At Empty Tables	Les Misérables Cast	Les Misérables: The Motion Picture Soundtrack Deluxe (Deluxe Edition)	3:11
The End	JPOLND	The End	3:35
End Game [feat. Ed Sheeran & Future]	Taylor Swift	reputation	4:04
The End?	Johannes Ringen	Troll (Soundtrack from the Netflix Film)	3:14
Endgame #3/Chess Game #3	VARIOUS ARTISTS	Chess In Concert	6:43
Endless	Bethel Music	Reckless Love	3:57
Endless Alleluia	Bethel Music	Reckless Love	4:25
Endless Fight	Carpetman	Endless Fight	3:01
Enemies to Lovers	Joshua Kyan Aalampour	Enemies to Lovers	3:45
Enemy	Tommee Profitt	Cinematic Songs (Vol. 6)	3:10
Enemy (from the series Arcane League of Legends)	Imagine Dragons, J.I.D, Arcane & League of Legends	Enemy (from the series Arcane League of Legends)	2:53
England	Working For A Nuclear Free City	Working for a Nuclear Free City	1:09
Enough	Lin-Manuel Miranda	In the Heights (Original Broadway Cast Recording)	2:38
Epic I	Anaïs Mitchell	Hadestown (Original Broadway Cast Recording)	3:12
Epic II	Anaïs Mitchell	Hadestown (Original Broadway Cast Recording)	2:26
Epic III	Anaïs Mitchell	Hadestown (Original Broadway Cast Recording)	5:51
Epic III ("They danced...") [Instrumental]	Anaïs Mitchell	Hadestown (Original Broadway Cast Recording)	1:39
Epilogue	Les Misérables Cast	Les Misérables: The Motion Picture Soundtrack Deluxe (Deluxe Edition)	8:24
Epiphany	The Piano Guys	Limitless	4:42
Epiphany/Savages (Part 2) (Alternate Version)	VARIOUS ARTISTS	Walt Disney Records The Legacy Collection: Pocahontas	2:01
Escape	Kx5, deadmau5 & Kaskade [feat. Hayla]	Escape	4:00
Esther Accepts	VARIOUS ARTISTS	Meet Me In St. Louis (Original Motion Picture Soundtrack)	3:52
Ev'rybody Wants to Be a Cat	VARIOUS ARTISTS	Songs From The Aristocats	2:03
Evacuate the Dancefloor	Cascada	3D (Special Edition)	3:25
Eveline	Nickel Creek	Why Should The Fire Die?	3:11
Even If It Breaks Your Heart	Eli Young Band	Life At Best	3:40
Ever After	Original Broadway Cast of Into the Woods	Into the Woods (Original Broadway Cast Recording)	2:20
Ever After (Instrumental)	VARIOUS ARTISTS	Into the Woods (Original Motion Picture Soundtrack)	1:15
Evermore	VARIOUS ARTISTS	Beauty and the Beast (Original Motion Picture Soundtrack)	3:14
Every Good Thing	Young Collective, Red Licorice & Utah	Every Good Thing	3:15
Every High	Kyson	Every High	3:33
Every Storm (Runs Out Of Rain)	Gary Allan	Every Storm (Runs Out Of Rain)	3:46
Every Victory (Live)	The Belonging Co & Danny Gokey	Every Victory (Live)	8:47
Everybody (Backstreet's Back) (Extended Version)	Backstreet Boys	Backstreet Boys	4:47
Everybody Loves You	The Chicks	Gaslighter [Explicit]	3:38
Everybody's Gotta Live	Love	Reel to Real (Deluxe Version)	3:25
Everything I Know	Lin-Manuel Miranda	In the Heights (Original Broadway Cast Recording)	3:56
everything i wanted	Billie Eilish	everything i wanted	4:05
Everytime I Hear Your Name (Radio Edit)	Cascada	Evacuate The Dancefloor	3:12
Exactly How I Feel (feat. Gucci Mane)	Lizzo	Cuz I Love You (Deluxe) [Explicit]	2:23
Execution	VARIOUS ARTISTS	Pocahontas	1:34
exes	Tate McRae	exes [Clean]	2:39
Expecting to Fly (2017 Remaster)	Neil Young	Decade	3:48
Experience	Dalal	The Einaudi Sound	6:04
Extreme Days	TobyMac	Momentum	3:40
Faded (ODESZA Remix)	Zhu	Faded (The Remixes)	3:58
Fairytale	Milky Chance	Sadnecessary (Bonus Track Version)	4:16
Fall	TobyMac	This Is Not A Test (Deluxe Edition)	3:53
Fall For You	Secondhand Serenade	A Twist In My Story	3:04
Fall In Line	Christina Aguilera	Liberation [Explicit]	4:08
The Fallen Interlude	blink-182	blink-182 [Explicit]	2:12
Falling Fast (feat. GG Magree)	Seven Lions	Beyond The Veil	4:54
Familiar Taste of Poison	Halestorm	Halestorm [Expanded]	4:04
Family Hunt	VARIOUS ARTISTS	Kipo And The Age Of Wonderbeasts (Season 3 Mixtape)	1:58
The Family Madrigal	Lin-Manuel Miranda, Germaine Franco & Encanto - Cast	Encanto (Original Motion Picture Soundtrack)	4:17
Family Tale	VARIOUS ARTISTS	Kipo And The Age Of Wonderbeasts (Season 2 Mixtape)	2:56
Fantaisie-impromptu in C-Sharp Minor, Op. 66	Vladimir Horowitz	Chopin: Works for Piano	4:30
Fantine's Arrest (Live)	Claude-Michel Schönberg & Alain Boublil	Les Misérables Live! (2010 London Cast Recording)	3:33
Fantine's Arrest (Live)	Claude-Michel Schönberg & Alain Boublil	Les Misérables (10th Anniversary Concert Live at Royal Albert Hall)	3:53
Fantine’s Arrest	Les Misérables Cast	Les Misérables: The Motion Picture Soundtrack Deluxe (Deluxe Edition)	1:59
Fantine’s Death	Les Misérables Cast	Les Misérables: The Motion Picture Soundtrack Deluxe (Deluxe Edition)	2:52
The Farmer And The Cowman	VARIOUS ARTISTS	Oklahoma! (2019 Broadway Cast Recording)	3:22
Farmer Refuted	Lin-Manuel Miranda	Hamilton (Original Broadway Cast Recording) [Explicit]	1:52
The Fear	The Score	Pressure [Explicit]	3:03
Feed The Birds (Tuppence A Bag) (From "Mary Poppins"/Soundtrack Version)	VARIOUS ARTISTS	Mary Poppins	3:51
Feel Good Inc.	Gorillaz	Demon Days	3:42
Feel Invincible	Skillet	Unleashed Beyond (Special Edition)	3:49
Feel It [feat. Mr. TalkBox]	TobyMac	This Is Not A Test (Deluxe Edition)	4:39
Feel It (feat. Tunji Ige)	GTA	Good Times Ahead [Explicit]	3:34
Feel So Cold	Carpetman	Feel So Cold	4:04
feel something	Bea Miller	feel something [Explicit]	3:00
Feel This Moment	Pitbull	Global Warming: Meltdown (Deluxe Version) [Clean]	3:49
The Feeling [feat. Halsey]	Justin Bieber	Purpose (Deluxe)	4:04
Feeling Good	Michael Bublé	It's Time	3:57
Feeling Good	Apashe & Cherry Lena	Feeling Good	3:16
Feeling Good (Bassnectar Remix)	VARIOUS ARTISTS	Verve Remixed: The First Ladies	3:46
Feeling This	blink-182	blink-182 [Explicit]	2:52
Feels	Kiiara	low kii savage [Explicit]	3:02
The Feels	Labrinth	Ends & Begins [Explicit]	3:18
Feels Great (feat. Fetty Wap & CVBZ)	Cheat Codes [feat. CVBZ & Fetty Wap]	Feels Great (feat. Fetty Wap & CVBZ) [Explicit]	3:13
Ferris Wheel	VARIOUS ARTISTS	Kipo And The Age Of Wonderbeasts (Season 3 Mixtape)	1:54
Fever	Cascada	3D (Special Edition)	3:19
Fight The War	VARIOUS ARTISTS	Kipo And The Age Of Wonderbeasts (Season 1 Mixtape) [Clean]	1:54
Filthy	Justin Timberlake	Man of the Woods [Explicit]	4:53
The Final Battle	Les Misérables Cast	Les Misérables: The Motion Picture Soundtrack Deluxe (Deluxe Edition)	3:06
Finale	VARIOUS ARTISTS	Dear Evan Hansen (Original Broadway Cast Recording)	1:36
Finale	Lin-Manuel Miranda	In the Heights (Original Broadway Cast Recording)	5:28
Finale	VARIOUS ARTISTS	The Hunchback of Notre Dame (Studio Cast Recording)	13:42
Finale  "Wicked" (From "Wicked" Original Broadway Cast Recording/2003)	VARIOUS ARTISTS	Wicked	1:41
Finale (Meet Me In St. Louis)	VARIOUS ARTISTS	Meet Me In St. Louis (Original Motion Picture Soundtrack)	3:32
Finale: Children Will Listen	Original Broadway Cast of Into the Woods	Into the Woods (Original Broadway Cast Recording)	5:11
Finale/Children Will Listen (Pt. 1)	VARIOUS ARTISTS	Into the Woods (Original Motion Picture Soundtrack)	3:30
Finale/Children Will Listen (Pt. 2)	VARIOUS ARTISTS	Into the Woods (Original Motion Picture Soundtrack)	1:46
Find an Island	BENEE	STELLA & STEVE [Explicit]	3:12
Finding You	Kesha	Rainbow [Explicit]	2:52
Finding You	Kesha	Rainbow [Explicit]	2:52
Fire	Louis The Child & Evalyn	Fire	3:26
Fire (Glee Cast Version)	Glee Cast [feat. Kristin Chenoweth]	Fire (Glee Cast Version)	3:24
Fire In My Head	Two Feet	Fire In My Head	3:08
Firebird	Milky Chance	Blossom	3:41
Fireflies	LUM!X & Jordan Rys	Fireflies	2:23
Fireflies	Owl City	Ocean Eyes	3:48
First	Gabby Douglas	Conqueror	3:48
First And Last Waltz	Nickel Creek	Why Should The Fire Die?	1:53
The First Attack	Les Misérables Cast	Les Misérables: The Motion Picture Soundtrack Deluxe (Deluxe Edition)	1:21
First Burn	Ari Afsar, Julia Harriman, Lexi Lawson, Rachelle Ann Go & Shoba Narayan	First Burn	3:02
First Dance	The Piano Guys	Limitless	4:36
The First Noel	Lady A	On This Winter's Night (Deluxe)	3:23
The First Noël (with Faith Hill)	Josh Groban	Noël	4:33
Fitzpleasure	alt-J	An Awesome Wave	3:39
Fix A Heart	Demi Lovato	Unbroken	3:13
Fix My Eyes	for KING & COUNTRY	RUN WILD. LIVE FREE. LOVE STRONG.	3:35
Fix You	Sun Theory	Fix You	3:40
Flapper Girl	The Lumineers	The Lumineers	3:15
Flashed Junk Mind	Milky Chance	Sadnecessary (Bonus Track Version)	4:22
Flicker	The Piano Guys	Limitless	3:16
Float On	Modest Mouse	Good News For People Who Love Bad News [Explicit]	3:28
flood on the floor	Purity Ring	another eternity	3:14
Flowers	Anaïs Mitchell	Hadestown (Original Broadway Cast Recording)	3:31
Flowers In The Water	Nathan Evans	1994	2:23
Flowers In Your Hair	The Lumineers	The Lumineers	1:49
Fluxland 2017	Dzeko	Fluxland 2017	2:37
Flying On The Ground Is Wrong	Neil Young International Harvesters	A Treasure	4:47
Focus	Ariana Grande	Focus	3:31
Follow Me Down [feat. Neon Hitch]	VARIOUS ARTISTS	Almost Alice	3:23
For The Cross	Bethel Music	Tides	5:38
For Forever	VARIOUS ARTISTS	Dear Evan Hansen (Original Broadway Cast Recording)	5:01
For Good (From "Wicked" Original Broadway Cast Recording/2003)	VARIOUS ARTISTS	Wicked	5:06
For Her	The Chicks	Gaslighter [Explicit]	5:27
For the Love of a Princess (From "Braveheart")	2Cellos	Score	5:11
For the Turnstiles (2017 Remaster)	Neil Young	Decade	3:01
Forever (Live)	Kari Jobe	Majestic (Live)	6:50
Forgive Me (Live) (feat. Izzy Bizu) (ODESZA VIP Remix)	ODESZA	Forgive Me (Live) / A Moment Apart (Live)	4:03
Formula	Labrinth	Euphoria (Original Score from the HBO Series) [Explicit]	1:32
Found/Tonight	Ben Platt & Lin-Manuel Miranda	Found/Tonight	2:59
Fragile	2Cellos	2CELLOS	3:26
Freaks (Radio Edit)	Timmy Trumpet [feat. Savage]	Freaks	2:49
Fresh Pair of Eyes	Brooke Waggoner	Fresh Pair of Eyes	3:49
Fresher Than A Night At The W	TobyMac	Welcome To Diverse City	0:48
Friday (Dopamine Re-Edit)	Riton & Nightcrawlers [feat. Mufasa & Hypeman]	Friday (Dopamine Re-Edit)	2:49
Friend Like Me	VARIOUS ARTISTS	Aladdin Original Broadway Cast Recording	7:32
FRIENDS	Marshmello & Anne-Marie	FRIENDS [Explicit]	3:22
Friends	Flume [feat. Reo Cragun]	Friends [Explicit]	3:44
Friends on the Other Side	VARIOUS ARTISTS	The Princess and the Frog (Original Motion Picture Soundtrack)	3:34
From Hank to Hendrix	Neil Young	Harvest Moon	5:17
From The Jump (Duet Version)	James Arthur & Kelly Clarkson	From The Jump (Duet Version)	3:52
From Now On	VARIOUS ARTISTS	The Greatest Showman (Original Motion Picture Soundtrack)	5:49
Frosty The Snowman (Remastered 2006)	Bing Crosby	Bing Crosby - Christmas Classics	2:13
Fuego	Alok & Bhaskar	Fuego	3:08
Fullness (Acoustic)	Elevation Worship	There Is a Cloud	4:25
The Funeral	Band Of Horses	Everything All The Time	5:22
Funhouse	P!nk	Greatest Hits...So Far!!! [Explicit]	3:24
Funky Monkey	VARIOUS ARTISTS	Rio: Music From The Motion Picture	2:24
Gabriel's Message	Matt Maher	The Advent of Christmas	2:56
Gallows Pole	Neil Young & Crazy Horse	Americana [+video]	4:14
The Game	Milky Chance	Mind The Moon	3:33
Game Of Survival	Ruelle	Madness	2:58
Game of Thrones Medley	2Cellos	Score	5:04
Gangsta	VARIOUS ARTISTS	Suicide Squad: The Album [Clean]	2:57
Gangsta's Paradise	Coolio	Gangsta's Paradise	4:00
The Garden	The Crane Wives	Foxlore	4:03
Gaslighter	The Chicks	Gaslighter [Explicit]	3:24
Gasolina	Daddy Yankee	Barrio Fino (Bonus Track Version)	3:12
Gasoline	Halsey	BADLANDS (Deluxe) [Explicit]	3:19
A Gathering Storm	Anaïs Mitchell	Hadestown (Original Broadway Cast Recording)	1:33
GDFR (feat. Sage the Gemini & Lookas)	Flo Rida	My House	3:10
The General	Dispatch	Bang Bang	4:06
Get Back	Ludacris	The Red Light District [Explicit]	4:30
Get Back To The Country	Neil Young International Harvesters	A Treasure	2:27
Get Better	alt-J	The Dream [Explicit]	5:51
Get Happy	Matt Maeson	Get Happy	3:49
Get a Job	Neil Young & Crazy Horse	Americana [+video]	3:00
Get This Party Started	TobyMac	Momentum	2:22
Getaway Car	TobyMac	Welcome To Diverse City	4:27
Getting into You	Relient K	Two Lefts Don't Make a Right...But Three Do (Gold Edition)	3:24
Getting Ready for the Party	VARIOUS ARTISTS	Meet Me In St. Louis (Original Motion Picture Soundtrack)	1:37
GHETTO STAR	Ryan Castro & COQE	GHETTO STAR [Explicit]	3:19
Ghost Town	Adam Lambert	The Original High (Deluxe Version) [Explicit]	3:28
Giants in the Sky	VARIOUS ARTISTS	Into the Woods (Original Motion Picture Soundtrack)	2:26
Giants in the Sky (Bonus Track)	Original Broadway Cast of Into the Woods	Into the Woods (Original Broadway Cast Recording)	1:56
Gin Tonic	Parov Stelar	The Demon Diaries [Explicit]	3:18
The Girl From Ipanema	Frank Sinatra & Antonio Carlos Jobim	Sinatra/Jobim: The Complete Reprise Recordings	3:20
Girl In A Country Song	Maddie & Tae	Start Here	3:37
Girl With One Eye	Florence + The Machine	Lungs	3:38
Girl With One Eye	Florence + The Machine	Lungs (Deluxe Edition)	3:37
Give Your Heart A Break	Demi Lovato	Unbroken	3:25
Glitter & Gold	Barns Courtney	The Attractions Of Youth [Explicit]	2:56
Gloomy Sunday (Take 1)	Billie Holiday	The Centennial Collection	3:11
Gloria / Hark! The Herald Angels Sing	The Piano Guys	Christmas Together	3:53
Glorious (feat. Skylar Grey)	Macklemore	GEMINI [Clean]	3:42
Glorious Unfolding	Steven Curtis Chapman	The Glorious Unfolding	4:46
Glory	The Score	Pressure [Explicit]	2:46
Go	blink-182	blink-182 [Explicit]	1:53
Go Tell It On The Mountain	Tommee Profitt	The Birth Of A King	3:16
Go To Sleep	Bearson [feat. Kailee Morgue]	Go To Sleep	3:57
God Bless The Child (Album Version)	August Rush (Motion Picture Soundtrack)	August Rush (Soundtrack)	4:28
God I Look to You	Bethel Music	Discover Bethel Music	7:33
God Is Good	Jonathan McReynolds	Make More Room	3:28
God Of Breakthrough	Mack Brock	Greater Things	4:06
God of Revival (Live)	Bethel Music	Revival's In The Air (Live)	8:35
God Rest Ye Merry Gentlemen	Bing Crosby	White Christmas	2:17
God Rest Ye Merry Gentlemen	Tommee Profitt	The Birth Of A King	3:08
God Rest Ye Merry Gentlemen	Pentatonix	A Pentatonix Christmas Deluxe	2:29
God Save the Queen	Neil Young & Crazy Horse	Americana [+video]	4:08
God With Us (Live) [feat. Bryan Torwalt]	Jesus Culture	Let It Echo Unplugged (Live)	5:58
God, Your Mama, And Me [feat. Backstreet Boys]	Florida Georgia Line	Dig Your Roots	3:03
Godzilla	Kesha	Rainbow [Explicit]	2:08
Godzilla [feat. Juice WRLD]	Eminem	Music To Be Murdered By [Explicit]	3:30
Gold	Kiiara	low kii savage [Explicit]	3:45
Gold (Stupid Love)	Excision & Illenium [feat. Shallows]	Gold (Stupid Love)	4:55
Gold Digger [feat. Jamie Foxx]	Kanye West	Late Registration [Explicit]	3:27
Golden Bangkok	VARIOUS ARTISTS	Chess In Concert	1:56
golden hour	JVKE	golden hour	3:29
Gone	TobyMac	Welcome To Diverse City	3:27
GONE	NF	HOPE	4:06
Gone, I'm Gone	Anaïs Mitchell	Hadestown (Original Broadway Cast Recording)	1:41
Good Day (feat. MisterWives and Curtis Roach)	Jax Anderson, MisterWives & Curtis Roach	Good Day (feat. MisterWives and Curtis Roach) [Explicit]	3:36
Good For You	VARIOUS ARTISTS	Dear Evan Hansen (Original Broadway Cast Recording)	3:05
Good Girls Go Bad (feat. Leighton Meester)	Cobra Starship	Hot Mess [Explicit]	3:16
The Good In Me	Jon Bellion	The Human Condition [Explicit]	3:43
Good King Wenceslas	The Piano Guys	A Family Christmas	3:51
Good Life	Mitch King	A Life Under the Sun	2:50
Good Morning	Max Frost	Gold Rush [Explicit]	2:33
Good News	Apashe	The Good, The Bad & The Fake	4:44
Good Old Days	Macklemore	GEMINI [Clean]	4:00
Good Things Fall Apart	Illenium	ASCEND [Explicit]	3:36
Good Things Fall Apart	Illenium & Jon Bellion	Good Things Fall Apart	3:36
Good Vibrations (From "Hotel Transylvania 3")	VARIOUS ARTISTS	Kids Movie Songs 2018	3:39
Goodbye (feat. Xillions)	le Shuuk [feat. Xillions]	Goodbye (feat. Xillions)	2:35
Goodbyes	VARIOUS ARTISTS	Kipo And The Age Of Wonderbeasts (Season 3 Mixtape)	0:53
Gooey	Glass Animals	ZABA [Explicit]	4:49
goosebumps	Travis Scott	Birds In The Trap Sing McKnight [Explicit]	4:03
Gotta Go	TobyMac	Welcome To Diverse City	2:48
Graves Into Gardens (Live)	Elevation Worship	Graves Into Gardens (Live)	7:32
Great Are You Lord	All Sons & Daughters [feat. Leslie Jordan & David Leonard]	All Sons & Daughters (feat. Leslie Jordan & David Leonard)	4:56
The Great Escape	Boys Like Girls	Boys Like Girls	3:26
The Greatest Show	VARIOUS ARTISTS	The Greatest Showman: Reimagined	2:54
The Greatest Show	VARIOUS ARTISTS	The Greatest Showman (Original Motion Picture Soundtrack)	5:02
Greedy	Ariana Grande	Dangerous Woman [Clean]	3:34
Grey Riders	Neil Young International Harvesters	A Treasure	5:58
Grow as We Go (feat. Sara Bareilles)	Ben Platt [feat. Sara Bareilles]	Grow As We Go (feat. Sara Bareilles)	4:10
Grown-Up Christmas List	Amy Grant	Home For Christmas	5:02
Grrrl Like	VARIOUS ARTISTS	Kipo And The Age Of Wonderbeasts (Season 1 Mixtape) [Clean]	2:53
Guillotine [feat. Travis Mendes]	Jon Bellion	The Human Condition [Explicit]	3:28
Guns and Ships	Lin-Manuel Miranda	Hamilton (Original Broadway Cast Recording) [Explicit]	2:07
Hallelujah	Pentatonix	A Pentatonix Christmas Deluxe	4:28
Hallelujah	Pentatonix	Hallelujah	4:29
Hallowed Be Thy Name	Walk Off the Earth	Taekwondo (Original Motion Picture Soundtrack)	5:12
Halo	Beyoncé	I AM...SASHA FIERCE	4:21
Hammer	Point North	Hammer [Explicit]	3:40
HandClap	Fitz & The Tantrums	Fitz and The Tantrums	3:13
Hands Up	Black Eyed Peas	Elephunk [Explicit]	3:36
Hangover [feat. Flo Rida]	VARIOUS ARTISTS	Silvester 2021 [Explicit]	4:04
Happier When You’re Gone	alt-J	The Dream [Explicit]	4:00
HAPPY	NF	HOPE	4:03
Happy Holidays	VARIOUS ARTISTS	Hello Winter (Lovely Music for the Cold Days)	2:38
Hard Drive Gold	alt-J	The Dream [Explicit]	2:38
Hark! The Herald Angels Sing	Tommee Profitt	The Birth Of A King	5:14
Hark! The Herald Angels Sing/Gloria (In Excelsis Deo)	Mariah Carey	Merry Christmas	2:59
Hark! The Herald Angels Sing/It Came Upon A Midnight Clear (Medley / Remastered 2006)	Bing Crosby	Bing Crosby - Christmas Classics	3:06
Harvest (2009 Remaster)	Neil Young	Harvest (2009 Remaster)	3:09
Harvest (2017 Remaster)	Neil Young	Decade	3:11
Harvest Moon	Neil Young	Harvest Moon	5:03
Hate Me	Ellie Goulding & Juice WRLD	Hate Me	3:06
Havana	Pentatonix	PTX Presents: Top Pop, Vol. I	2:35
Havana	Camila Cabello	Camila	3:37
Havana (feat. Jocelyn Alice & Krnfx)	Walk Off the Earth	Havana (feat. Jocelyn Alice & KRNFX)	3:10
Havana (Remix)	Camila Cabello & Daddy Yankee	Havana (Remix)	3:19
Have Yourself A Merry Little Christmas	Amy Grant	Home For Christmas	2:37
Have Yourself A Merry Little Christmas	Judy Garland	The Complete Decca Masters (Plus)	2:47
Have Yourself A Merry Little Christmas (Remastered 2006)	Bing Crosby	Bing Crosby - Christmas Classics	2:50
Hayloft	Nickel Creek	A Dotted Line	3:17
He Is Born (Reprise) [feat. Chris Tomlin]	Tommee Profitt	The Birth Of A King	2:16
He Loves And She Loves	Ella Fitzgerald & Nelson Riddle	Ella Fitzgerald Sings The George And Ira Gershwin Song Book (Expanded Edition)	2:49
Healing Incantation (From "Tangled"/Soundtrack Version)	VARIOUS ARTISTS	Tangled	0:54
Hear Me Now	Alok, Zeeba & Bruno Martini	Hear Me Now	3:13
Heart Attack	Demi Lovato	Demi	3:30
A Heart Full Of Love	Les Misérables Cast	Les Misérables: The Motion Picture Soundtrack Deluxe (Deluxe Edition)	2:01
A Heart Full Of Love (Reprise)	Les Misérables Cast	Les Misérables: The Motion Picture Soundtrack Deluxe (Deluxe Edition)	1:30
Heart of Gold (2017 Remaster)	Neil Young	Decade	3:07
Heart of Gold (2009 Remaster)	Neil Young	Harvest (2009 Remaster)	3:07
Heart On Fire	Eric Church	Heart	4:18
Heart On My Sleeve	GATTÜSO & Laidback Luke [feat. Sarah Reeves]	Heart On My Sleeve	3:29
The Heart Wants What It Wants	Selena Gomez	For You	3:47
Heartstrings	M-22 & Ella Henderson	Heartstrings	3:31
Heat Waves	Glass Animals	Dreamland [Explicit]	3:58
Heat Waves (with iann dior)	Glass Animals	Dreamland (Real Life Edition) [Explicit]	2:55
Heaven  [feat. Israel Houghton]	Gungor	Beautiful Things	2:43
Heaven Help Me	Lizzo	Cuz I Love You (Deluxe) [Explicit]	3:22
Heaven Meets Earth (feat. Leslie Jordan & David Leonard)	All Sons & Daughters [feat. Leslie Jordan & David Leonard]	Poets & Saints (feat. Leslie Jordan & David Leonard)	4:24
Heaven's Light	VARIOUS ARTISTS	The Hunchback of Notre Dame (Studio Cast Recording)	1:55
Heavy In Your Arms	Florence + The Machine	Lungs (Deluxe Edition)	4:45
Hedwig's Theme (From "Harry Potter and the Philosopher's Stone")	The City Of Prague Philharmonic Orchestra	The Complete Harry Potter Film Music Collection	4:51
Helena	Nickel Creek	Why Should The Fire Die?	4:45
Helium	Glass Animals	Dreamland [Explicit]	5:28
Hellfire	VARIOUS ARTISTS	The Hunchback of Notre Dame (Studio Cast Recording)	3:41
Hello	Walk Off the Earth	Hello	4:53
Hello	Martin Solveig	Smash [Explicit]	4:41
Hello, Little Girl	Original Broadway Cast of Into the Woods	Into the Woods (Original Broadway Cast Recording)	2:33
Hello, Little Girl	VARIOUS ARTISTS	Into the Woods (Original Motion Picture Soundtrack)	2:31
Hello!	Trey Parker, Robert Lopez & Matt Stone	The Book Of Mormon (Original Broadway Cast Recording) [Explicit]	2:52
Helpless	Crosby, Stills, Nash & Young	Deja Vu	3:37
Helpless	Lin-Manuel Miranda	Hamilton (Original Broadway Cast Recording) [Explicit]	4:09
Here Comes Santa Claus (Right Down Santa Claus Lane) [feat. The Andrews Sisters]	Bing Crosby	The Voice Of Christmas - The Complete Decca Christmas Songbook	3:03
Here With Me	d4vd	Here With Me	4:03
Here's Your Letter	blink-182	blink-182 [Explicit]	2:54
Heroes On Fire	VARIOUS ARTISTS	Kipo And The Age Of Wonderbeasts (Season 2 Mixtape)	3:23
Heroes On Fire (Karaoke Version)	VARIOUS ARTISTS	Kipo And The Age Of Wonderbeasts (Season 2 Mixtape)	3:21
Hey Baby (Drop It to the Floor)	Pitbull	Planet Pit (Deluxe Version) [Explicit]	3:54
Hey Brother	Avicii	TRUE	4:15
Hey Girl [feat. Florence Welch]	Lady Gaga	Joanne [Explicit]	4:15
Hey Mami	Sylvan Esso	Sylvan Esso	3:20
Hey Now	TobyMac	Welcome To Diverse City	3:44
Hey, Little Songbird	Anaïs Mitchell	Hadestown (Original Broadway Cast Recording)	3:32
Hi Ren	Ren	Hi Ren [Explicit]	8:35
High	VARIOUS ARTISTS	Fifty Shades Freed (Original Motion Picture Soundtrack) [Explicit]	3:17
High Above	Bryan & Katie Torwalt	Champion	4:58
High Flyin' Bird	Neil Young & Crazy Horse	Americana [+video]	5:28
High On My Lows	Sawyer Hill	High On My Lows [Explicit]	2:59
Higher	Gungor	Beautiful Things	4:39
His Kiss, the Riot	Anaïs Mitchell	Hadestown (Original Broadway Cast Recording)	3:03
History Has Its Eyes on You	Lin-Manuel Miranda	Hamilton (Original Broadway Cast Recording) [Explicit]	1:37
HIT IT	Black Eyed Peas [feat. Saweetie & Lele Pons]	HIT IT [Explicit]	3:55
Hitchhiker	Neil Young	Le Noise [+Digital Booklet]	5:31
Ho Hey	The Lumineers	The Lumineers	2:43
Hold On	Crooked Colours	Langata [Explicit]	4:06
Hold On (The Break)	Walk Off the Earth	Sing It All Away	3:27
Hold Your Hands Up (Radio Edit)	Cascada	Evacuate The Dancefloor	3:45
HOLIDAY	Lil Nas X	HOLIDAY [Clean]	2:35
HOLIDAY	Lil Nas X	HOLIDAY [Explicit]	2:35
Holy	Brenton Brown	Because Of Your Love	4:13
Holy (Song Of The Ages) (Live)	The Belonging Co & Andrew Holt	Holy (Song Of The Ages) (Live)	6:22
Holy Forever	Chris Tomlin	Always	5:08
Holy Spirit	Francesca Battistelli	If We're Honest	5:02
Holy Spirit (Live) [feat. Kim Walker-Smith]	Jesus Culture	Live From New York	8:09
Holy Water	We The Kingdom	Holy Water	4:02
Holy Water	Big & Rich	Horse of a Different Color	4:16
Home	VARIOUS ARTISTS	Bright: The Album [Explicit]	3:22
Home	Livingston	Lighthouse	3:32
Home	Pixie and The Partygrass Boys	Utah Made	7:16
Home	Walk Off the Earth	Vol. 2 [Explicit]	3:36
Home We'll Go (Take My Hand)	Steve Aoki	Neon Future II	5:08
Homegrown	Haux	All We've Known	4:02
Honest	Song House & Kyndal Inskeep	Honest	2:51
Honey Bones	Dope Lemon	Honey Bones [Explicit]	5:25
Honeybee	The Head and the Heart	Living Mirage	3:16
HOPE	NF	HOPE	4:25
Hope It's Something Good	The Chicks	Gaslighter [Explicit]	4:06
hostage	Billie Eilish	dont smile at me	3:49
Hot Girl Bummer	blackbear	everything means nothing [Clean]	3:08
hot girl bummer	blackbear	everything means nothing [Explicit]	3:08
Hot In Herre	Nelly	Nellyville	3:48
Hot Sugar	Glass Animals	Dreamland [Explicit]	3:54
Hot Wings (I Wanna Party)	VARIOUS ARTISTS	Rio: Music From The Motion Picture	2:16
Hotel Room Service	Pitbull	Pitbull Starring In: Rebelution [Explicit]	3:57
House Of The Lord	Phil Wickham	Hymn Of Heaven	4:16
House Of Miracles	Brandon Lake	House Of Miracles	5:38
how could u love somebody like me?	Artemas	how could u love somebody like me?	2:06
How Far I'll Go	VARIOUS ARTISTS	Moana (Original Motion Picture Soundtrack)	2:43
How Far I'll Go (Reprise)	VARIOUS ARTISTS	Moana (Original Motion Picture Soundtrack)	1:27
How Great Thou Art	Pentatonix	The Best Of Pentatonix Christmas	4:09
How Great Thou Art	Pentatonix	A Pentatonix Christmas Deluxe	4:08
How I Learned To Love The Bomb	Glass Animals	I Love You So F***ing Much [Explicit]	4:09
How Long?	Anaïs Mitchell	Hadestown (Original Broadway Cast Recording)	3:41
How Many Times	Dope Lemon	Honey Bones [Explicit]	4:45
How the Tide Rushes In	Anne Dudley	Poldark: Music from the TV Series (Deluxe Version)	3:03
How to Be Yours	Chris Renzema	I'll Be the Branches	4:49
Howl	Florence + The Machine	Lungs	3:34
The Hum	VARIOUS ARTISTS	Armada 15 Years	3:31
human	Christina Perri	head or heart	4:10
Human	Rag'n'Bone Man	Human	3:20
Human Nature	2Cellos	2CELLOS	2:47
Humans In Capes	VARIOUS ARTISTS	Kipo And The Age Of Wonderbeasts (Season 2 Mixtape)	2:15
Humble	Ren	Humble	2:55
Hundreds of Stories	In The Heights (Original Cast Recording)	In The Heights	3:39
Hungarian Rhapsody No. 2 (Piano Version)	VARIOUS ARTISTS	Reader's Digest Music: Favorites From The Classics Volume 12: Liszt's Greatest Hits	9:33
Hunger of the Pine	alt-J	This Is All Yours	5:00
Hunt You Down	Kesha	Rainbow [Explicit]	3:17
Hurricane	Luke Combs	This One's for You	3:42
Hurricane	Lin-Manuel Miranda	Hamilton (Original Broadway Cast Recording) [Explicit]	2:23
Hurricane Drunk	Florence + The Machine	Lungs	3:13
Hurt	2Cellos	2CELLOS	4:29
Husavik (My Hometown)	VARIOUS ARTISTS	Eurovision Song Contest: The Story of Fire Saga (Music from the Netflix Film)	3:22
Hymn	Kesha	Rainbow [Explicit]	3:25
Hymn	Kesha	Rainbow [Explicit]	3:25
I Am a Child	Neil Young	Neil Young Archives Vol. I (1963 - 1972)	2:19
I Am Here for You	Trey Parker, Robert Lopez & Matt Stone	The Book Of Mormon (Original Broadway Cast Recording) [Explicit]	2:04
I Am Loved	Maverick City Music	Maverick City Vol.1	10:00
I AM WOMAN	Emmy Meli	I AM WOMAN [Explicit]	3:53
I Believe in You (2017 Remaster)	Neil Young	Decade	3:27
I Cain’t Say No	VARIOUS ARTISTS	Oklahoma! (2019 Broadway Cast Recording)	3:58
I Can't Give You Anything But Love (I Can't Give You Anything But Love)	VARIOUS ARTISTS	Good Vibes Vol. 26	2:03
I Can't Make You Fall in Love Again	Glass Animals	I Love You So F***ing Much [Explicit]	4:49
I Did Something Bad	Taylor Swift	reputation	3:58
i don't think i love you anymore	Alaina Castillo	i don't think i love you anymore	3:49
I Don’t Know Why	Imagine Dragons	Evolve	3:10
I Don’t Wanna Live Forever (Fifty Shades Darker)	VARIOUS ARTISTS	Fifty Shades Darker (Original Motion Picture Soundtrack)	4:05
I Dreamed A Dream (From "Les Misérables")	Les Misérables Cast	Les Misérables: The Motion Picture Soundtrack Deluxe (Deluxe Edition)	4:37
I Dreamed a Dream (Live)	Claude-Michel Schönberg & Alain Boublil	Les Misérables Live! (2010 London Cast Recording)	3:40
I Feel Good	Pitbull [feat. Anthony Watts & DJWS]	I Feel Good	2:52
I Feel Like I'm Drowning	Two Feet	A 20 Something Fuck [Explicit]	3:05
I Feel Like I'm Drowning	Two Feet	A 20 Something F**k [Clean]	3:06
I Found	Amber Run	5AM (Expanded Edition)	4:33
I Get Along Without You Very Well (Remastered)	Frank Sinatra	In The Wee Small Hours	3:42
I Get Off	Halestorm	Halestorm [Expanded]	3:03
I Go to the Barn Because I Like The	Band Of Horses	Everything All The Time	3:06
I Guess This Is Goodbye / Maybe They're Magic	Original Broadway Cast of Into the Woods	Into the Woods (Original Broadway Cast Recording)	2:03
I Hate Basketball	VARIOUS ARTISTS	Meet Me In St. Louis (Original Motion Picture Soundtrack)	3:25
I Hate Everything About You	Three Days Grace	Three Days Grace (Expanded Edition) [Explicit]	3:52
I Hate This Part	The Pussycat Dolls	Doll Domination	3:38
I Heard The Bells On Christmas Day [feat. The Ken Darby Singers]	Bing Crosby	The Voice Of Christmas - The Complete Decca Christmas Songbook	2:46
I Hope You Dance	Lee Ann Womack	I Hope You Dance	4:54
I Knew You Were Trouble	Walk Off the Earth [feat. KrNFx]	I Knew You Were Trouble	3:35
I Knew You Were Trouble.	Taylor Swift	Red	3:38
I Know Him	Lin-Manuel Miranda	Hamilton (Original Broadway Cast Recording) [Explicit]	1:38
I Know Things Now	Original Broadway Cast of Into the Woods	Into the Woods (Original Broadway Cast Recording)	1:48
I Know Things Now	VARIOUS ARTISTS	Into the Woods (Original Motion Picture Soundtrack)	2:05
I Like It	Cardi B	Invasion of Privacy [Clean]	4:13
I Like It	Cardi B	Invasion of Privacy [Explicit]	4:13
I Like It [feat. Pitbull]	Enrique Iglesias	Euphoria (Standard US/Latin version)	3:51
I Like Me Better	Lauv	I met you when I was 18. (the playlist)	3:17
I Lost Something in the Hills	Sibylle Baier	Colour Green	3:28
I Love Rock 'N Roll	Joan Jett & the Blackhearts	I Love Rock 'N' Roll (Expanded Edition)	2:55
I Love to Laugh (From "Mary Poppins"/Soundtrack Version)	VARIOUS ARTISTS	Mary Poppins	2:43
I Love You Truly	VARIOUS ARTISTS	50 Canzoni per dire Ti Amo	2:47
I Miss The Days	NF	The Search	4:29
I Miss You	blink-182	blink-182 [Explicit]	3:47
I Only Have Eyes For You (Glee Cast Version)	Glee Cast	I Only Have Eyes For You (Glee Cast Version)	3:21
I Only Have Eyes For You (Glee Cast Version)	Glee Cast	Glee: The Music, The Complete Season Four	3:21
I Rise	Pentatonix	I Rise	3:21
I See Fire	Howard Shore	The Hobbit: The Desolation of Smaug (Original Motion Picture Soundtrack) [Special Edition]	5:00
I See Fire	Jonathan Young, Colm R. McGuinness & Matthew K. Heafy	I See Fire	4:58
I See the Light (From "Tangled" / Soundtrack Version)	VARIOUS ARTISTS	Tangled	3:44
I so Hate Consequences	Relient K	Mmhmm	4:01
I Speak Jesus	Here Be Lions	I Speak Jesus	5:16
I Surrender (feat. Leslie Jordan & David Leonard)	All Sons & Daughters [feat. Leslie Jordan & David Leonard]	Poets & Saints (feat. Leslie Jordan & David Leonard)	4:13
I Wait (feat. Leslie Jordan & David Leonard)	All Sons & Daughters [feat. Leslie Jordan & David Leonard]	Poets & Saints (feat. Leslie Jordan & David Leonard)	4:06
I Want It All	Coin	Dreamland	2:51
I Want It That Way	Backstreet Boys	Millennium	3:33
I Will Follow	Chris Tomlin	And If Our God Is For Us...	3:40
I Will Possess Your Heart	Death Cab For Cutie	Narrow Stairs	8:25
I Wish	Dallas String Quartet	Between Us	4:43
I Wish You A Merry Christmas (Remastered 2006)	Bing Crosby	Bing Crosby - Christmas Classics	1:55
I'd Pluck a Fair Rose	Anne Dudley	Poldark: Music from the TV Series (Deluxe Version)	2:08
I'll Be Home for Christmas	Michael Bublé	Christmas	4:24
I'll Be Home For Christmas	Amy Grant	Home For Christmas	3:28
I'll Find You	Lecrae [feat. Tori Kelly]	I'll Find You	3:38
I'm an Albatraoz Again	AronChupa & Little Sis Nora	I'm an Albatraoz Again [Explicit]	2:26
I'm Beginning To See The Light (Remastered)	Bobby Darin	Great Gentlemen Of Song / Spotlight On Bobby Darin	2:17
I'm Good (Blue)	David Guetta & Bebe Rexha	I'm Good (Blue) [Explicit]	2:55
I'm Lost Without You	blink-182	blink-182 [Explicit]	6:20
I'm a Mess	Bebe Rexha	Expectations	3:15
I'm Not Calling You A Liar	Florence + The Machine	Lungs (Deluxe Edition)	3:05
I'm Not Calling You A Liar	Florence + The Machine	Lungs	3:05
I'm not Pretty	JESSIA	I'm not Pretty [Explicit]	1:58
I'm Not That Girl (From "Wicked" Original Broadway Cast Recording/2003)	VARIOUS ARTISTS	Wicked	2:58
I'm Not That Girl (Reprise) (From "Wicked" Original Broadway Cast Recording/2003)	VARIOUS ARTISTS	Wicked	0:50
I'm Shipping Up To Boston	Dropkick Murphys	The Warrior's Code [Explicit]	2:33
I'm with You	Avril Lavigne	Let Go	3:43
I've Got The World On A String (Remastered 2000)	Frank Sinatra	Classic Sinatra - His Great Performances 1953-1960	2:10
I've Got You Under My Skin	Ella Fitzgerald	Ella Fitzgerald Sings The Cole Porter Song Book (Expanded Edition)	2:42
I've Got You Under My Skin (Remastered 1998)	Frank Sinatra	Classic Sinatra - His Great Performances 1953-1960	3:43
Idea 22 (Anya Nami Remix)	Gibran Alcocer & Anya Nami	Idea 22 (Anya Nami Remix)	2:29
idontwannabeyouanymore	Billie Eilish	dont smile at me	3:23
Ievan Polkka (Club Remix)	The Kiffness [feat. Bilal Göregen]	Ievan Polkka (Club Remix)	3:01
If I Could Tell Her	VARIOUS ARTISTS	Dear Evan Hansen (Original Broadway Cast Recording)	4:08
If I Ever Fall In Love	Pentatonix	Pentatonix (Deluxe Version)	3:14
If I Had You	Adam Lambert	For Your Entertainment	3:48
If I Never Knew You	VARIOUS ARTISTS	Walt Disney Records The Legacy Collection: Pocahontas	3:21
If I Never See Your Face Again	Maroon 5	It Won't Be Soon Before Long. [Explicit]	3:21
If I Were A Boy	Beyoncé	I AM...SASHA FIERCE	4:09
If it's True	Anaïs Mitchell	Hadestown (Original Broadway Cast Recording)	4:13
If Only I	Loud Luxury, Two Friends & Bebe Rexha	If Only I	2:23
If U Seek Amy	Britney Spears	Circus	3:36
If You Love Her	Forest Blakk	Every Little Detail	3:37
Ill-M-I	TobyMac	Welcome To Diverse City	3:29
Immanuel - Original Key Performance Track w/ Background Vocals	Point Of Grace	Immanuel (Studio Series Performance Track)	3:35
In The Air	TobyMac	Momentum	4:01
In the Bathroom	Lounge Lizard Publications Limited	Learn Italian Words	1:30
In Christ Alone (Live)	Passion	Passion: Let The Future Begin	5:39
In The Dark	Dev	The Night The Sun Came Up [Explicit]	3:46
In The End (Mellen Gi Remix)	Tommee Profitt	In The End	3:38
In the Heights	Lin-Manuel Miranda	In the Heights (Original Broadway Cast Recording)	7:38
In Jesus Name (God Of Possible) [Piano Version]	Katy Nichole	In Jesus Name (God Of Possible) [Piano Version]	3:40
In My Blood / Swan Lake	The Piano Guys	Limitless	3:57
In My Life	Les Misérables Cast	Les Misérables: The Motion Picture Soundtrack Deluxe (Deluxe Edition)	4:16
In My Mind	Dynoro & Gigi D'Agostino	In My Mind	3:05
In the Name of Love	Martin Garrix & Bebe Rexha	In the Name of Love	3:19
In The River (Live) [feat. Kim Walker-Smith]	Jesus Culture	Let It Echo (Live)	4:37
In Your Arms (Alan Walker Remix)	Illenium	ASCEND (Remixes) [Explicit]	4:09
Insanity	Illenium	ILLENIUM	3:03
Insatiable	Kim Walker-Smith	Insatiable	4:26
Into the Glade	VARIOUS ARTISTS	Walt Disney Records The Legacy Collection: Pocahontas	3:00
Into the Unknown	VARIOUS ARTISTS	Frozen 2 (Original Motion Picture Soundtrack)	3:14
Into the Unknown (Panic! At The Disco Version)	VARIOUS ARTISTS	Frozen 2 (Original Motion Picture Soundtrack)	3:09
Into You	Ariana Grande	Dangerous Woman [Clean]	4:04
Intoxicated	Martin Solveig & GTA	Intoxicated (Original Mix)	4:17
Introduction	Henry N. Raymond	Learn in Your Car: Spanish - Level 1	1:50
Inútil	Lin-Manuel Miranda	In the Heights (Original Broadway Cast Recording)	2:50
Irene	TobyMac	Momentum	4:12
Irreplaceable	Beyoncé	B'Day Deluxe Edition	3:47
Is There A Ghost	Band Of Horses	Cease To Begin	2:59
Is This Love (Remix) [feat. LVNDSCAPE & Bolier]	Bob Marley [feat. LVNDSCAPE & Bolier]	Is This Love (Remix)	3:20
It Ain't Me	Kygo & Selena Gomez	It Ain't Me	3:40
It Came Upon A Midnight Clear	Tommee Profitt	The Birth Of A King	4:48
It Had To Be You (Dark Version)	VARIOUS ARTISTS	Haunting of the Queen Mary (Original Motion Picture Soundtrack)	3:47
It Is So	Elevation Worship	At Midnight - EP	5:50
It Is Well (Live)	Bethel Music	You Make Me Brave (Live)	6:25
It Is Well With My Soul (Album Version)	Chris Rice	Peace Like A River: The Hymns Project	4:39
It Might Have Been	Neil Young International Harvesters	A Treasure	2:43
It Takes Two	Original Broadway Cast of Into the Woods	Into the Woods (Original Broadway Cast Recording)	2:48
It Takes Two	VARIOUS ARTISTS	Into the Woods (Original Motion Picture Soundtrack)	2:29
It Won't Be Long Now	In The Heights (Original Cast Recording)	In The Heights	4:32
It's All Right With Me	Ella Fitzgerald	Ella Fitzgerald Sings The Cole Porter Song Book (Expanded Edition)	3:07
It's De-Lovely	Ella Fitzgerald	Ella Fitzgerald Sings The Cole Porter Song Book (Expanded Edition)	2:42
It's A Lovely Day Today [feat. Paul Weston & His Orchestra]	VARIOUS ARTISTS	It's A Lovely Day Today - Vintage Autumn Jazz Vibes	2:28
It's The Most Wonderful Time Of The Year (Remastered 2007)	Amy Grant	Home For Christmas	2:26
It's Party Time (From "Hotel Transylvania 3")	Joe Jonas	It's Party Time (From "Hotel Transylvania 3")	2:29
It's Quiet Uptown	Lin-Manuel Miranda	Hamilton (Original Broadway Cast Recording) [Explicit]	4:30
It's Really You	VARIOUS ARTISTS	Kipo And The Age Of Wonderbeasts (Season 3 Mixtape)	0:59
It’s All So Incredibly Loud	Glass Animals	Dreamland [Explicit]	4:19
It’s A Scandal! It’s A Outrage!	VARIOUS ARTISTS	Oklahoma! (2019 Broadway Cast Recording)	2:51
J Train	TobyMac	Momentum	3:27
Jalapeño	Big & Rich	Comin' to Your City	2:57
Jamack Theme	VARIOUS ARTISTS	Kipo And The Age Of Wonderbeasts (Season 1 Mixtape) [Clean]	0:40
Javert At The Barricade	Les Misérables Cast	Les Misérables: The Motion Picture Soundtrack Deluxe (Deluxe Edition)	1:45
Javert's Suicide	Les Misérables Cast	Les Misérables: The Motion Picture Soundtrack Deluxe (Deluxe Edition)	2:55
Jealous Of The Moon	Nickel Creek	Why Should The Fire Die?	4:41
JEKYLL & HIDE	Bishop Briggs	CHAMPION [Explicit]	3:16
Jenny of Oldstones (Game of Thrones)	Florence + The Machine	Jenny of Oldstones (Game of Thrones)	3:08
Jerome	Lizzo	Cuz I Love You (Deluxe) [Explicit]	3:51
Jesu, Joy Of Man's Desiring	Amy Grant	Home For Christmas	4:48
Jesus' Chariot	Neil Young & Crazy Horse	Americana [+video]	5:37
Jireh	Elevation Worship & Maverick City Music	Old Church Basement	9:59
Joke's On You	VARIOUS ARTISTS	Birds of Prey: The Album [Explicit]	3:04
Joy To The World	Bing Crosby	Bing Crosby's Christmas Gems	1:48
Joy To The World 2 (He Is Come)	Tommee Profitt	The Birth Of A King	4:01
Joy To The World/For Unto Us A Child Is Born (Medley)	Amy Grant	Home For Christmas	2:32
joy.	for KING & COUNTRY	Burn The Ships	3:54
Juice	Lizzo	Cuz I Love You (Deluxe) [Explicit]	3:15
Julianna Calm Down	The Chicks	Gaslighter [Explicit]	4:46
Jumpin', Jumpin'	Destiny's Child	#1's	3:47
Jungle	Saint Mesa	Jungle EP	3:22
Just Around the Riverbend	VARIOUS ARTISTS	Pocahontas	2:27
Just Be Held	Casting Crowns	Thrive	3:41
Just Like Fire (From the Original Motion Picture "Alice Through The Looking Glass")	P!nk	Just Like Fire (From the Original Motion Picture "Alice Through The Looking Glass")	3:35
JUST LIKE YOU	NF	CLOUDS (THE MIXTAPE)	4:11
Just My Soul Responding	Amber Run	5AM (Expanded Edition)	3:58
Just One More Time	VARIOUS ARTISTS	Kipo And The Age Of Wonderbeasts (Season 3 Mixtape)	1:30
Just One Of Those Things	Ella Fitzgerald	The Very Best Of The Cole Porter Songbook	3:30
Justice (Get Up, Stand Up)	Nakkia Gold, Wiz Khalifa & Bob Marley	Justice (Get Up, Stand Up) [Explicit]	3:18
Kansas City	VARIOUS ARTISTS	Oklahoma! (2019 Broadway Cast Recording)	2:02
Karma	AJR	Neotheater [Explicit]	4:05
King Hugo	VARIOUS ARTISTS	Kipo And The Age Of Wonderbeasts (Season 2 Mixtape)	1:05
King Of The Earth (Album Version)	August Rush (Motion Picture Soundtrack)	August Rush (Soundtrack)	3:44
King Of My Castle (Don Diablo Edit)	Keanu Silva & Don Diablo	King Of My Castle (Don Diablo Edit)	2:53
King of My Heart (Live)	Bethel Music	Starlight (Live)	4:59
Kiss or Kill	Stela Cole	Woman of the Hour [Explicit]	3:01
Kiss With A Fist	Florence + The Machine	Lungs	2:04
Know Me Better	Vikkstar & Masked Wolf [feat. Jme]	Know Me Better	2:56
Know You Will	Hillsong UNITED & Benjamin William Hastings	Know You Will	3:38
Krazy	Pitbull	Pitbull Starring In: Rebelution [Clean]	3:51
La Jumpa	Arcángel	Sr. Santos [Explicit]	4:16
La Santa	Bad Bunny	YHLQMDLG [Explicit]	3:26
labour	Paris Paloma	Cacophony [Explicit]	3:58
Lacrimosa	Apashe	Requiem [Explicit]	3:37
The Lady is a Tramp	Tony Bennett	Duets II	3:18
Lady Sings The Blues	Billie Holiday	The Complete Billie Holiday On Verve 1945 - 1959	3:44
Lake Michigan	VARIOUS ARTISTS	The Secret Life Of Walter Mitty (Music From And Inspired By The Motion Picture)	3:47
Lake Of Silver Bells	Carbon Leaf	Nothing Rhymes With Woman (Amazon Exclusive)	5:34
Lalala	Y2K & bbno$	Lalala [Explicit]	2:40
Lament	Original Broadway Cast of Into the Woods	Into the Woods (Original Broadway Cast Recording)	2:03
Lampshades on Fire	Modest Mouse	Strangers to Ourselves [Explicit]	3:07
Land of Yesterday	VARIOUS ARTISTS	Anastasia (Original Broadway Cast Recording)	3:35
Larger Than Life	Backstreet Boys	Millennium	3:52
The Last Goodbye	Howard Shore	The Hobbit: The Battle of the Five Armies (Original Motion Picture Soundtrack)	4:07
The Last Goodbye (feat. Bettye LaVette)	ODESZA [feat. Bettye LaVette]	The Last Goodbye (feat. Bettye LaVette)	5:59
Last Midnight	VARIOUS ARTISTS	Into the Woods (Original Motion Picture Soundtrack)	3:34
Last Of My Kind	Shaboozey	Where I've Been, Isn't Where I'm Going [Explicit]	3:22
Last Resort (Reimagined)	Falling In Reverse	Last Resort (Reimagined) [Explicit]	4:44
Late Have I Loved You	Gungor	Beautiful Things	4:18
Laurey's Entrance	VARIOUS ARTISTS	Oklahoma! (2019 Broadway Cast Recording)	0:37
LAYERS	NF	CLOUDS (THE MIXTAPE)	3:15
Le Disko	Shiny Toy Guns	We Are Pilots	3:23
Lean Wit It, Rock Wit It [feat. Peanut & Charlay]	Dem Franchize Boyz	On Top Of Our Game [Explicit]	3:49
Learn To Let Go	Kesha	Rainbow [Explicit]	3:37
Leave Me Alone	NF	The Search	5:08
Left Hand Free	alt-J	This Is All Yours	2:53
Legend	The Score	ATLAS [Explicit]	3:09
Legend of the Lamp	VARIOUS ARTISTS	Aladdin (Original Motion Picture Soundtrack)	1:25
Lesson 1: Basics	Henry N. Raymond	Learn in Your Car: Spanish - Level 1	5:39
Lesson 2: Basic Phrases	Henry N. Raymond	Learn in Your Car: Spanish - Level 1	3:53
Lesson 4: Transporation Phrases	Henry N. Raymond	Learn in Your Car: Spanish - Level 1	7:20
Lesson 5: Money	Henry N. Raymond	Learn in Your Car: Spanish - Level 1	5:01
Lesson 6: Hotel	Henry N. Raymond	Learn in Your Car: Spanish - Level 1	6:49
Lesson 7: Important Words	Henry N. Raymond	Learn in Your Car: Spanish - Level 1	7:18
Lesson 8: Directions	Henry N. Raymond	Learn in Your Car: Spanish - Level 1	5:45
Lesson 9: Numbers	Henry N. Raymond	Learn in Your Car: Spanish - Level 1	2:25
Lesson 10: More Numbers	Henry N. Raymond	Learn in Your Car: Spanish - Level 1	2:13
Lesson 11: Big Numbers	Henry N. Raymond	Learn in Your Car: Spanish - Level 1	3:20
Lesson 12: Very Big Numbers	Henry N. Raymond	Learn in Your Car: Spanish - Level 1	4:44
Lesson 13: At the Restaurant	Henry N. Raymond	Learn in Your Car: Spanish - Level 1	5:56
Lesson 14: Shopping	Henry N. Raymond	Learn in Your Car: Spanish - Level 1	6:06
Lesson 15: Time - General	Henry N. Raymond	Learn in Your Car: Spanish - Level 1	4:30
Lesson 16: Time of Day	Henry N. Raymond	Learn in Your Car: Spanish - Level 1	5:28
Lesson 17: Questions	Henry N. Raymond	Learn in Your Car: Spanish - Level 1	5:14
Lesson 18: Shops	Henry N. Raymond	Learn in Your Car: Spanish - Level 1	5:16
Lesson 19: Nouns	Henry N. Raymond	Learn in Your Car: Spanish - Level 1	8:12
Lesson 21: Verbs	Henry N. Raymond	Learn in Your Car: Spanish - Level 1	10:02
Lesson 22: Prepositions	Henry N. Raymond	Learn in Your Car: Spanish - Level 1	6:39
Lesson 23: Prepositional Pronouns	Henry N. Raymond	Learn in Your Car: Spanish - Level 1	5:16
Lesson 24: Possessive Adjectives	Henry N. Raymond	Learn in Your Car: Spanish - Level 1	6:20
Lesson 25: Conjunctions & Similar Words	Henry N. Raymond	Learn in Your Car: Spanish - Level 1	2:44
Lesson 26: Sentences and Phrases – General	Henry N. Raymond	Learn in Your Car: Spanish - Level 1	9:28
Lesson 27: Sentences and Phrases – Negative	Henry N. Raymond	Learn in Your Car: Spanish - Level 1	4:39
Lesson 28: Forming Questions	Henry N. Raymond	Learn in Your Car: Spanish - Level 1	5:21
Lesson 29: Sentences & Phrases – General	Henry N. Raymond	Learn in Your Car: Spanish - Level 1	8:09
Lesson 30:  Sentences & Phrases – Transportation	Henry N. Raymond	Learn in Your Car: Spanish - Level 1	6:16
Lesson 31: Sentences & Phrases – Money	Henry N. Raymond	Learn in Your Car: Spanish - Level 1	3:50
Lesson 32: Sentences  & Phrases – Hotel	Henry N. Raymond	Learn in Your Car: Spanish - Level 1	6:34
Lesson 33:  Sentences  & Phrases – Getting Around	Henry N. Raymond	Learn in Your Car: Spanish - Level 1	5:29
Lesson 34: Sentences  & Phrases – Directions	Henry N. Raymond	Learn in Your Car: Spanish - Level 1	4:33
Lesson 35: Sentences & Phrases – Conversation	Henry N. Raymond	Learn in Your Car: Spanish - Level 1	5:39
Lesson 36: Sentences  & Phrases – Internet	Henry N. Raymond	Learn in Your Car: Spanish - Level 1	5:16
Lessons 20: Adjectives & Adverbs	Henry N. Raymond	Learn in Your Car: Spanish - Level 1	13:18
Lessson 3: Transporation Nouns	Henry N. Raymond	Learn in Your Car: Spanish - Level 1	7:11
Let 'Em Talk	Kesha	Rainbow [Explicit]	3:05
LET EM PRAY	NF	HOPE	3:34
Let It Snow ! Let It Snow	VARIOUS ARTISTS	Les plus belles chansons de Noël	2:03
Let It Snow / Winter Wonderland	The Piano Guys	A Family Christmas	3:27
Let It Snow! Let It Snow! Let It Snow! (Remastered 2006)	Bing Crosby	Bing Crosby - Christmas Classics	2:05
Let Me Down Easy	Max Frost	Intoxication	3:57
Let You Down	NF	Perception	3:32
Let Your Fingers Do The Walking	Neil Young International Harvesters	A Treasure	3:00
Let's Call The Whole Thing Off	Ella Fitzgerald & Louis Armstrong	Ella And Louis Again	4:12
Let's Go Walk	Bronze Whale	Let's Go Walk	3:22
Liar	Camila Cabello	Liar	3:27
Lie	NF	Perception	3:29
Life Itself	Glass Animals	How To Be A Human Being [Explicit]	4:41
Lifestyle (feat. Adam Levine)	Jason Derulo [feat. Adam Levine]	Lifestyle (feat. Adam Levine) [Explicit]	2:33
Lift You Up [feat. Ryan Stevenson]	TobyMac	This Is Not A Test (Deluxe Edition)	3:30
Light	San Holo	Light	3:59
Light It Up (Remix)	Major Lazer	Peace Is The Mission (Extended) [Explicit]	2:46
The Lighthouse's Tale	Nickel Creek	Nickel Creek	5:01
Lights Shine Bright [feat. Hollyn]	TobyMac	This Is Not A Test (Deluxe Edition)	4:35
Like a Girl	Lizzo	Cuz I Love You (Deluxe) [Explicit]	3:04
Like a Hurricane (2017 Remaster)	Neil Young	Decade	8:17
Like A Match	TobyMac	This Is Not A Test (Deluxe Edition)	3:07
Like A Match (Garcia’s Remix)	TobyMac	This Is Not A Test (Deluxe Edition)	3:36
Like Real People Do	Hozier	Hozier (Expanded Edition)	3:18
like that	Bea Miller	chapter two: red [Explicit]	3:05
Limitless	The Piano Guys	Limitless	4:30
Lingerie	Lizzo	Cuz I Love You (Deluxe) [Explicit]	3:21
LION	Elevation Worship	LION	5:54
Lion	Saint Mesa	Lion	2:50
Lips Of An Angel	Hinder	Extreme Behavior	4:21
Listen With Your Heart - Pt. 1	VARIOUS ARTISTS	Pocahontas	1:12
Listen With Your Heart - Pt. 2	VARIOUS ARTISTS	Pocahontas	2:46
Little Bad Girl (Feat. Taio Cruz & Ludacris)	David Guetta	Nothing but the Beat [Explicit]	3:12
A Little Bit Happy	Talk	A Little Bit Happy	3:15
Little Drummer Boy	Pentatonix	The Best Of Pentatonix Christmas	4:13
The Little Drummer Boy (Remastered 2006)	Bing Crosby	Bing Crosby - Christmas Classics	3:00
Little Drummer Boy / Do You Hear What I Hear	The Piano Guys	Christmas Together	3:54
Little Fall Of Rain	Les Misérables Cast	Les Misérables: The Motion Picture Soundtrack Deluxe (Deluxe Edition)	2:32
Little Girl Gone	Chinchilla	Little Girl Gone [Explicit]	3:09
A Little Messed Up	June	A Little Messed Up	2:48
The Littlest Angel (Remastered 2006)	Bing Crosby	Bing Crosby - Christmas Classics	4:00
Livin' for the Weekend	Fitz & The Tantrums	All the Feels	2:55
Livin' it Up on Top	Anaïs Mitchell	Hadestown (Original Broadway Cast Recording)	5:29
Lollipop (Album Version (Edited)) [feat. Static Major]	Lil Wayne	Tha Carter III	4:07
Lone Digger	Caravan Palace	<I°_°I>	3:50
Lonely Room	VARIOUS ARTISTS	Oklahoma! (2019 Broadway Cast Recording)	2:56
The Lonely Waltz	Joshua Kyan Aalampour	Winter Solace	2:02
The Loner (2017 Remaster)	Neil Young	Decade	3:51
Long May You Run (2017 Remaster)	Neil Young	Decade	3:48
The Long Way Home	Big & Rich	Did It for the Party	3:36
Look Down	Les Misérables Cast	Les Misérables: The Motion Picture Soundtrack Deluxe (Deluxe Edition)	3:16
Look Down, Lord (From "Rosewood") (Instrumental)	John Williams	John Williams - Greatest Hits 1969-1999	4:11
Look What You Made Me Do	Taylor Swift	reputation	3:31
Look What You Made Me Do	Taylor Swift	reputation (Big Machine Radio Release Special)	3:32
Lose It	Kane Brown	Lose It	2:58
Lose Yourself	VARIOUS ARTISTS	ShadyXV [Explicit]	5:20
Losing My Mind	alt-J	The Dream [Explicit]	4:42
LOST [feat. Hopsin]	NF	CLOUDS (THE MIXTAPE)	3:55
Lost Boy	Ruth B.	Safe Haven	4:36
Lost Boy	Ruth B.	The Intro	4:36
Lost in the Ocean	Glass Animals	I Love You So F***ing Much [Explicit]	4:06
Lost In Space	Emmit Fenn	Lost In Space	3:42
Lost in This Moment (2009 Remaster)	Big & Rich	Greatest Hits	3:32
Lost in the Woods	VARIOUS ARTISTS	Frozen 2 (Original Motion Picture Soundtrack)	3:00
Love Ain't	Eli Young Band	Love Ain't	3:06
Love And Kisses [feat. Chick Webb And His Orchestra]	Ella Fitzgerald [feat. Chick Webb & His Orchestra]	The Early Years - Part 1 (1935-1938)	3:18
Love And War	Neil Young	Le Noise [+Digital Booklet]	5:33
Love Broke Thru	TobyMac	This Is Not A Test (Deluxe Edition)	3:57
Love Feels Like [feat. dc Talk]	TobyMac	This Is Not A Test (Deluxe Edition)	4:19
Love Game	Bread Beatz	Love Game	2:06
Love Gone Wrong	You+Me	rose ave.	4:22
Love Is a Bitch	Two Feet	Love Is a Bitch [Explicit]	3:01
Love Is In The House	TobyMac	Momentum	5:18
Love Is a Rose	Neil Young	Songs for Judy	2:20
Love It When You Hate Me (feat. blackbear)	Avril Lavigne	Love Sux [Explicit]	2:25
Love Lies	VARIOUS ARTISTS	Love, Simon (Original Motion Picture Soundtrack) [Explicit]	3:21
Love Like Mine	Stela Cole	Woman of the Hour [Explicit]	3:08
Love On The Brain	Rihanna	ANTI (Deluxe) [Explicit]	3:42
Love So Soft	Kelly Clarkson	Meaning of Life	2:52
Love Story	2Cellos	Score	3:24
Love Theme from The Godfather	2Cellos	Score	3:54
Love to Keep Me Warm	Laufey & dodie	Love to Keep Me Warm	2:38
Love Train	Big & Rich	Horse of a Different Color	3:47
Love the Way You Lie	Walk Off the Earth	Vol. 2 [Explicit]	4:25
Love Won't Give Up	Elevation Worship	At Midnight - EP	4:39
Love Yourself	Sufjan Stevens	Love Yourself / With My Whole Heart	3:48
lovely	Billie Eilish & Khalid	lovely	3:20
Lovely Ladies	VARIOUS ARTISTS	Les Misérables (Original Broadway Cast Recording)	3:50
Lovely Ladies (Live)	Claude-Michel Schönberg & Alain Boublil	Les Misérables Live! (2010 London Cast Recording)	3:42
Lovely Ladies (Live)	Claude-Michel Schönberg & Alain Boublil	Les Misérables (10th Anniversary Concert Live at Royal Albert Hall)	2:08
Lover, Lover	Jerrod Niemann	Judge Jerrod & The Hung Jury	3:13
Lullaby	VARIOUS ARTISTS	Super Chilled	3:55
Lullaby	BENNETT	Lullaby	3:07
Lullaby Of The Leaves	Anita O'Day	The Complete Anita O'Day Verve-Clef Sessions	3:10
Mad World	Timmy Trumpet & Gabry Ponte	Mad World	2:33
Mad World	Timmy Trumpet	Mad World [Explicit]	2:33
Main Theme - Definitive Edition	Gareth Coker	Ori and the Blind Forest (Definitive Edition)	2:00
Main Title	August Rush (Motion Picture Soundtrack)	August Rush (Soundtrack)	2:19
Main Title (Meet Me In St. Louis)	VARIOUS ARTISTS	Meet Me In St. Louis (Original Motion Picture Soundtrack)	3:01
Main Title / Once Upon A Dream / Prologue (From "Sleeping Beauty"/Soundtrack Version)	VARIOUS ARTISTS	Sleeping Beauty	2:57
Make You Feel My Love (Instrumental Version)	Wedding Music Experts, Instrumental Love Songs & Cover Classics	New Wedding Acoustic Guitar Songs: A Thousand Years	3:48
Makin Whoopee	Dinah Washington	Essential Dinah Washington	2:29
Malena	2Cellos	Score	4:10
The Mambo Craze	De-Phazz	Godsdog [Explicit]	4:08
Mambo Rap	Parov Stelar	Mambo Rap	3:23
Mamma Mia (feat. Mentissa) [Techno Mix]	BENNETT [feat. Mentissa]	Mamma Mia (feat. Mentissa) [Techno Mix]	3:21
Man Down	Walk Off the Earth	Vol. 2 [Explicit]	3:01
The Man I Love	Peggy Lee	The Man I Love	3:45
The Man I Love	Helen Forrest	Voice Of The Name Bands	3:22
A Man Needs a Maid (2009 Remaster)	Neil Young	Harvest (2009 Remaster)	4:02
A Man Needs a Maid (2017 Remaster)	Neil Young	Decade	4:00
Mansion [feat. Fleurie]	NF	Mansion	5:23
Many A New Day	VARIOUS ARTISTS	Oklahoma! (2019 Broadway Cast Recording)	3:09
Maple Leaf Rag	Scott Joplin	Maple Leaf Rag	3:05
March March	The Chicks	Gaslighter [Explicit]	3:53
March Of The Witch Hunters (From "Wicked" Original Broadway Cast Recording/2003)	VARIOUS ARTISTS	Wicked	1:31
Marianelli: Darcy's Letter (From "Pride & Prejudice" Soundtrack)	Jean-Yves Thibaudet	Pride and Prejudice OST	3:56
Marianelli: The Living Sculptures Of Pemberley (From "Pride & Prejudice" Soundtrack)	Jean-Yves Thibaudet	Pride and Prejudice OST	3:01
Marianelli: A Postcard to Henry Purcell (From "Pride & Prejudice" Soundtrack)	Jean-Yves Thibaudet	Pride and Prejudice OST	2:39
Mariella	Khruangbin & Leon Bridges	Texas Moon	5:10
Marry Song	Band Of Horses	Cease To Begin	3:23
A Marshmallow World	Bing Crosby	The Voice Of Christmas - The Complete Decca Christmas Songbook	2:40
A Marshmallow World	Dean Martin	The Dean Martin Christmas Album	2:40
Mary	The Happy Fits	Concentrate	3:14
Mary Did You Know?	Tommee Profitt	The Birth Of A King	4:09
Mary, Did You Know?	Pentatonix	The Best Of Pentatonix Christmas	3:22
Master Of The House	Les Misérables Cast	Les Misérables: The Motion Picture Soundtrack Deluxe (Deluxe Edition)	4:48
Master Of The House (Live)	Claude-Michel Schönberg & Alain Boublil	Les Misérables (10th Anniversary Concert Live at Royal Albert Hall)	5:21
May it Be	2Cellos	Score	3:55
Maybe This Time (Glee Cast Version) (Cover of Liza Minnelli)	Glee Cast	Glee: The Music, Volume 1	2:59
maybe, i'm afraid	lovelytheband	finding it hard to smile [Explicit]	3:09
me & ur ghost	blackbear	everything means nothing [Clean]	3:21
me & ur ghost	blackbear	everything means nothing [Explicit]	3:21
Me Too	Meghan Trainor	Thank You (Deluxe)	3:01
Mean	Taylor Swift	Speak Now	3:57
Meant to Be (feat. Florida Georgia Line)	Bebe Rexha	All Your Fault: Pt. 2 [Explicit]	2:43
Meet Me In St. Louis, Louis	VARIOUS ARTISTS	Meet Me In St. Louis (Original Motion Picture Soundtrack)	1:56
Meet Me In St. Louis, Louis	VARIOUS ARTISTS	Meet Me In St. Louis (Original Motion Picture Soundtrack)	1:25
Meet Me Inside	Lin-Manuel Miranda	Hamilton (Original Broadway Cast Recording) [Explicit]	1:23
Meet the Plastics	Reneé Rapp & Auli'i Cravalho	Mean Girls (Music From The Motion Picture) [Explicit]	1:29
Megabunny Attack	VARIOUS ARTISTS	Kipo And The Age Of Wonderbeasts (Season 1 Mixtape) [Clean]	1:09
MegaWalrus Attack	VARIOUS ARTISTS	Kipo And The Age Of Wonderbeasts (Season 3 Mixtape)	1:02
Mele Kalikimaka (Merry Christmas)	Bing Crosby	White Christmas	2:55
Mele Kalikimaka (Single Version)	Bing Crosby	Christmas With Bing Crosby	2:55
Melon and the Coconut	Glass Animals	Dreamland [Explicit]	2:28
mememe	Bbno$ & Lentra	mememe [Explicit]	2:21
Merry Go Round	the JaneDear girls	The JaneDear Girls	3:15
Mes affaires	Aqua	Mes affaires [Explicit]	3:04
Mexican Fender	Weezer	Pacific Daydream	3:09
Mi Gente	J Balvin	Vibras	3:05
Mia & Sebastian’s Theme	Justin Hurwitz, Justin Paul & Benj Pasek	La La Land (Original Motion Picture Soundtrack)	1:38
Michael in the Bathroom	Joe Iconis	Be More Chill (Original Cast Recording) [Explicit]	4:57
Michelle (Remastered 2009)	The Beatles	Rubber Soul (Remastered)	2:42
MIDDLE OF THE NIGHT	Elley Duhé	MIDDLE OF THE NIGHT	3:04
Midnight	Khruangbin & Leon Bridges	Texas Sun	5:14
Midnight City	M83	Hurry Up, We're Dreaming	4:01
Mighty Warrior	Elevation Worship	Only King Forever	4:57
Miles To Your Heart	Sultan + Shepard, Rock Mafia & Bahari	Miles To Your Heart	3:00
Milkshake	Kelis	The Hits [Explicit]	3:02
A Million Dreams	VARIOUS ARTISTS	The Greatest Showman (Original Motion Picture Soundtrack)	4:29
A Million Dreams	VARIOUS ARTISTS	The Greatest Showman: Reimagined	4:33
A Million Dreams	The Piano Guys	A Million Dreams	4:45
A Million Dreams (Reprise)	VARIOUS ARTISTS	The Greatest Showman (Original Motion Picture Soundtrack)	1:00
Million Reasons	Lady Gaga	Joanne [Explicit]	3:25
Million Reasons	Lady Gaga	Joanne (Deluxe) [Explicit]	3:25
Mine, Mine, Mine	VARIOUS ARTISTS	Pocahontas	3:05
Minnie The Moocher	Cab Calloway	Minnie The Moocher (Selected Recordings)	3:16
Miracles	The Piano Guys	Limitless	6:13
Misirlou (Theme From Pulp Fiction)	2Cellos	2CELLOS	2:13
Misty Mountains	Howard Shore	The Hobbit: An Unexpected Journey (Original Motion Picture Soundtrack) [Special Edition]	1:42
Moh Squared	Moh Gang Musik	All Star [Explicit]	2:20
Moment	Roses & Revolutions	Roses & Revolutions	3:08
Moment (Acoustic)	Roses & Revolutions	Stripped	3:18
A Moment Apart	ODESZA	A Moment Apart [Explicit]	3:54
Moments in the Woods	VARIOUS ARTISTS	Into the Woods (Original Motion Picture Soundtrack)	3:07
Momentum	TobyMac	Momentum	3:23
Monster	Lady Gaga	The Fame Monster [Clean]	4:09
Monster	dodie	Human [Explicit]	4:05
The Monster [feat. Rihanna]	Eminem	The Marshall Mathers LP2 (Deluxe) [Explicit]	4:10
Monsters (feat. Demi Lovato and blackbear)	All Time Low [feat. Demi Lovato & blackbear]	Monsters (feat. Demi Lovato and blackbear) [Explicit]	2:54
Mood	24kgoldn [feat. Iann Dior]	Mood [Explicit]	2:20
Mood Rings	Relient K	Two Lefts Don't Make a Right...But Three Do (Gold Edition)	3:18
Moon River	2Cellos	Score	3:12
The Moon Will Sing	The Crane Wives	Coyote Stories	3:41
Moondance	August Rush (Motion Picture Soundtrack)	August Rush (Soundtrack)	1:48
Moondance	August Rush (Motion Picture Soundtrack)	August Rush (Soundtrack)	2:19
Moonlight Sonata. Piano Sonata No. 14 in C-Sharp Minor "Almost a Fantasy." Great for Mozart Effect and Pure Enjoyment.	Ludwig van Beethoven	Moonlight Sonata. Piano Sonata No. 14 in C-Sharp Minor "Almost a Fantasy." Great for Mozart Effect and Pure Enjoyment.	16:49
Moral of the Story	Ashe	Moral of the Story [Explicit]	3:21
More More More (feat. Lubalin) (Effin Remix)	Apashe	I Killed The Orchestra (Remixes)	3:18
Morning Song	The Lumineers	The Lumineers	5:16
The Moss	Cosmo Sheldrake	The Moss	4:03
The Most Horrible One	VARIOUS ARTISTS	Meet Me In St. Louis (Original Motion Picture Soundtrack)	4:25
Mother Knows Best (Reprise) (From "Tangled"/Soundtrack Version)	VARIOUS ARTISTS	Tangled	1:38
Motion Picture Soundtrack	Ramin Djawadi	Westworld: Season 1 (Music from the HBO Series)	2:42
Motor City	Neil Young International Harvesters	A Treasure	3:21
The Motto	Tiësto & Ava Max	The Motto	2:44
MOTTO	NF	HOPE	3:37
Move (Keep Walkin’)	TobyMac	This Is Not A Test (Deluxe Edition)	3:41
Mr. Navigator (Steve Aoki's 'I Am The Captain Now' Remix)	Armin van Buuren	Balance (Remixes) [Explicit]	3:42
Mr. Sandman	The Chordettes	Mr. Sandman	2:24
Mr. Soul	Neil Young	Unplugged	3:54
Mr. Soul (2017 Remaster)	Neil Young	Decade	2:49
Muévelo	Nicky Jam & Daddy Yankee	Muévelo	3:14
Mulholland	VARIOUS ARTISTS	Kipo And The Age Of Wonderbeasts (Season 3 Mixtape)	2:12
The Music Lesson / Oh, Sing Sweet Nightingale / Bad Boy Lucifer /A Message From His Majesty	VARIOUS ARTISTS	Cinderella	2:06
My Best Friend's Weddings	The Chicks	Gaslighter [Explicit]	4:19
my boy	Billie Eilish	dont smile at me	2:50
My Boy Builds Coffins	Florence + The Machine	Lungs	2:56
my ex's best friend	Machine Gun Kelly	Tickets To My Downfall [Explicit]	2:19
My Heart Goes (La Di Da)	Becky Hill	Only Honest On The Weekend [Explicit]	2:29
My Heart Will Go On (from "Titanic")	2Cellos	Score	5:43
My House	Flo Rida	My House	3:12
My Immortal	Lindsey Stirling	My Immortal	4:11
My Man	Glee Cast	Glee: The Music, Volume 6	2:15
My Name Is	Eminem	The Slim Shady LP [Explicit]	4:28
My Oh My	Camila Cabello	Romance [Explicit]	2:51
My Own Advice	William Black, Illenium & Alana Springsteen	My Own Advice [Explicit]	3:12
My Roving Heart (feat. Leslie Jordan & David Leonard)	All Sons & Daughters [feat. Leslie Jordan & David Leonard]	Poets & Saints (feat. Leslie Jordan & David Leonard)	3:11
My Shot	Lin-Manuel Miranda	Hamilton (Original Broadway Cast Recording) [Explicit]	5:33
My Soul Longs For You (Live) [feat. Chris Quilala & Kim Walker-Smith]	Jesus Culture	Come Away (Live)	7:49
My Stress	NF	The Search	4:12
Na Na Na	Pentatonix	Pentatonix (Deluxe Version)	2:35
Natural	Imagine Dragons	Natural	3:09
Natural Beauty	Neil Young	Harvest Moon	10:23
Natural Disaster	Zac Brown Band	Uncaged	3:02
NATURALMENTE	gedois.	NATURALMENTE	2:24
Need A Favor	Jelly Roll	Whitsitt Chapel [Explicit]	3:17
The Needle and the Damage Done (2009 Remaster)	Neil Young	Harvest (2009 Remaster)	2:03
The Needle and the Damage Done (2017 Remaster)	Neil Young	Decade	2:03
Neon Lights	Dope Lemon	Hounds Tooth	4:45
Never Alone	VARIOUS ARTISTS	You Raise Me Up	4:30
Never Be Like You (feat. Kai)	Flume	Skin [Explicit]	3:54
Never Coming Down	Faber Drive	can'T keEp a SecrEt	3:42
Never Enough	VARIOUS ARTISTS	The Greatest Showman (Original Motion Picture Soundtrack)	3:27
Never Enough (Reprise)	VARIOUS ARTISTS	The Greatest Showman (Original Motion Picture Soundtrack)	1:20
Never Let Me Go	Florence + The Machine	Water To Drink Not Write About	4:31
Never Let Me Go	Florence + The Machine	Ceremonials (Deluxe Edition)	4:31
Never Love an Anchor	The Crane Wives	Coyote Stories	3:48
Nevermind	Dennis Lloyd	Nevermind	2:36
Newton Wolves Rap	VARIOUS ARTISTS	Kipo And The Age Of Wonderbeasts (Season 1 Mixtape) [Clean]	2:09
The Next Right Thing	VARIOUS ARTISTS	Frozen 2 (Original Motion Picture Soundtrack)	3:36
Next to You	John Vincent III	Songs from the Valley	4:17
The Night Before Christmas (Remastered 2007)	Amy Grant	Home For Christmas	3:52
The Night We Met	Lord Huron	Strange Trails [Explicit]	3:28
Nightlight	Illenium & Annika Wells	Nightlight	3:42
Nightlight	Illenium	Fallen Embers (Deluxe Version) [Explicit]	3:42
Nightmare	Halsey	Nightmare [Explicit]	3:52
The Nights	Avicii	The Days / Nights (EP)	2:57
NO	Meghan Trainor	Thank You (Deluxe)	3:33
No Air	Jordin Sparks	Jordin Sparks	4:24
No Anchor	VARIOUS ARTISTS	Kipo And The Age Of Wonderbeasts (Season 2 Mixtape)	1:20
No Excuses	Meghan Trainor	TREAT MYSELF (DELUXE) [Explicit]	2:33
No Good Deed (From "Wicked" Original Broadway Cast Recording/2003)	VARIOUS ARTISTS	Wicked	3:31
No Hands (feat. Roscoe Dash & Wale)	Waka Flocka Flame	Flockaveli [Explicit]	4:23
No Light, No Light	Florence + The Machine	Ceremonials	4:34
No Light, No Light	Florence + The Machine	Ceremonials (Deluxe Edition)	4:34
No Longer Slaves (Radio Version)	Bethel Music & Jonathan David & Melissa Helser	No Longer Slaves (Radio Version)	4:10
No Me Diga	Lin-Manuel Miranda	In the Heights (Original Broadway Cast Recording)	2:26
No More	Original Broadway Cast of Into the Woods	Into the Woods (Original Broadway Cast Recording)	4:16
No One Is Alone	VARIOUS ARTISTS	Into the Woods (Original Motion Picture Soundtrack)	2:58
No One Is Alone (From "Into The Woods")	Original Broadway Cast of Into the Woods	Into the Woods (Original Broadway Cast Recording)	3:57
No One Mourns The Wicked (From "Wicked" Original Broadway Cast Recording/2003)	VARIOUS ARTISTS	Wicked	6:40
No One's Gonna Love You	Band Of Horses	Cease To Begin	3:37
No Promises (feat. Demi Lovato)	Cheat Codes [feat. Demi Lovato]	No Promises (feat. Demi Lovato)	3:42
No Roots	Alice Merton	No Roots	3:55
Noah	Amber Run	5AM (Expanded Edition)	3:54
nobody	Toby Mai	nobody	1:53
Noel (He Is Born)	Tommee Profitt	The Birth Of A King	4:21
Noel (Live) [feat. Lauren Daigle]	Chris Tomlin	Adore: Christmas Songs Of Worship (Live)	4:17
Non-Stop	Lin-Manuel Miranda	Hamilton (Original Broadway Cast Recording) [Explicit]	6:25
North and South Title Theme (From North and South BBC 2004 adaptation)	L'Orchestra Numerique & Thematic Pianos	Most Agreeable - The Music of Great British Period Drama	2:44
North and South Title Theme (From North and South)	L'Orchestra Numerique	Lark Rise to Cranford - Classic Television Themes	2:44
North Cape	The Piano Guys	Limitless	2:59
Northern Attitude	Noah Kahan	Stick Season (Forever) [Explicit]	4:27
Northern Lights	Phoenix Chorale & Charles Bruffy	Northern Lights - Choral Works by Ola Gjeilo	4:27
Nostalgia (feat. Missio)	Said the Sky	Nostalgia (feat. Missio)	3:52
Not Dead Yet	Devora	Not Dead Yet	4:12
Nothing Changes	Anaïs Mitchell	Hadestown (Original Broadway Cast Recording)	1:11
Nothing Else	Cody Carnes	Nothing Else	6:33
Nothing Else Matters (metallica)	Scott D. Davis	Rockfluence - solo piano	6:14
Nothing Is Perfect	Neil Young International Harvesters	A Treasure	5:00
Now Or Never	Halsey	hopeless fountain kingdom (Deluxe Plus) [Clean]	3:35
Now We are Free	2Cellos	Score	6:05
Numb	Marshmello & Khalid	Numb	2:36
Numb Little Bug	Em Beihold	Egg in the Backseat	2:49
O Come All Ye Faithful	Amy Grant	Home For Christmas	3:01
O Come All Ye Faithful	Tommee Profitt	The Birth Of A King	5:24
O Come O Come Emmanuel	Tommee Profitt	The Birth Of A King	3:13
O Come to the Altar (Live)	Elevation Worship	Here As In Heaven	5:53
O Come, All Ye Faithful	Pentatonix	A Pentatonix Christmas Deluxe	3:36
O come, O come, Emmanuel	Winchester Cathedral Choir, Andrew Lumsden & Sarah Baldock, organist	Advent in Winchester "O Come Emmanuel"	3:54
O Come, O Come, Emmanuel	BarlowGirl	Home For Christmas	4:58
O Come, O Come, Emmanuel	Matt Maher	O Come, O Come, Emmanuel	3:53
O Come, O Come, Emmanuel	Enya	And Winter Came (Amazon Exclusive)	3:40
O Come, O Come, Emmanuel	The Piano Guys	A Family Christmas	5:04
O God Forgive Us	for KING & COUNTRY	RUN WILD. LIVE FREE. LOVE STRONG. (Deluxe Anniversary Edition)	3:25
O Holy Night	Celine Dion	These are Special Times	5:20
O Holy Night	Josh Groban	Noël (Deluxe Edition)	4:48
O Holy Night	Tommee Profitt	The Birth Of A King	5:13
O Holy Night	Nat King Cole	The Christmas Song (Expanded Edition)	2:56
O Holy Night (Remastered 2006)	Bing Crosby	Bing Crosby - Christmas Classics	3:34
O Holy Night / Ave Maria	The Piano Guys	Christmas Together	5:17
O Little Town Of Bethlehem	Nat King Cole	The Christmas Song (Expanded Edition)	2:19
O Little Town Of Bethlehem	Tommee Profitt	The Birth Of A King	4:34
Oblivion	Bastille	All This Bad Blood	3:16
Obvious	blink-182	blink-182 [Explicit]	2:43
Ocean Avenue	Yellowcard	Ocean Avenue	3:18
ocean eyes	Billie Eilish	dont smile at me	3:20
Ocean of Love	VARIOUS ARTISTS	Kipo And The Age Of Wonderbeasts (Season 3 Mixtape)	2:12
Ocean Of Tears	Imanbek & DVBBS	Ocean Of Tears	3:05
Oceans (Where Feet May Fail)	Hillsong UNITED	Zion	8:56
Ode to Joy to the World	The Piano Guys	Christmas Together	4:06
Oh Susannah	Neil Young & Crazy Horse	Americana [+video]	5:02
Ohio (2017 Remaster)	Neil Young	Decade	3:00
Oklahoma	VARIOUS ARTISTS	Oklahoma! (2019 Broadway Cast Recording)	3:31
Old Flames (Can't Hold A Candle To You)	Kesha	Rainbow [Explicit]	4:26
Old King	Neil Young	Harvest Moon	2:57
The Old Laughing Lady (2017 Remaster)	Neil Young	Decade	5:59
Old Man (2017 Remaster)	Neil Young	Decade	3:22
Old Man (2009 Remaster)	Neil Young	Harvest (2009 Remaster)	3:22
Old Town Road (Diplo Remix)	Diplo	Diplo Presents Thomas Wesley: Chapter 1 - Snake Oil [Explicit]	3:24
Old Town Road	Walk Off the Earth	Old Town Road [Explicit]	2:36
Old Town Road (Remix)	Lil Nas X	7 EP [Explicit]	2:37
Oliver Twist	ArrDee	Oliver Twist [Explicit]	2:54
On & On	Cartoon & Daniel Levi	On & On	3:27
On & On	Armin van Buuren	Feel Again	2:51
On My Knees	RÜFÜS DU SOL	Surrender	4:21
On My Own	Les Misérables Cast	Les Misérables: The Motion Picture Soundtrack Deluxe (Deluxe Edition)	3:11
On My Way Back Home (Album Version)	Band Of Horses	Infinite Arms	3:28
On the Run	Glass Animals	I Love You So F***ing Much [Explicit]	4:34
On The Steps Of The Palace	Original Broadway Cast of Into the Woods	Into the Woods (Original Broadway Cast Recording)	2:34
On the Steps of the Palace	VARIOUS ARTISTS	Into the Woods (Original Motion Picture Soundtrack)	3:13
Once Upon a December	VARIOUS ARTISTS	Anastasia (Original Broadway Cast Recording)	2:59
Once Upon A Time In The West (from "Once Upon A Time In The West")	HAUSER	HAUSER Plays Morricone	2:51
One	Sleeping At Last	Atlas: Enneagram	3:23
One Day More	Les Misérables Cast	Les Misérables: The Motion Picture Soundtrack Deluxe (Deluxe Edition)	3:41
One Jump Ahead	VARIOUS ARTISTS	Aladdin (Original Motion Picture Soundtrack)	2:22
One Last Hope	Alan Menken, Hercules - Cast & Disney	Hercules (Original Motion Picture Soundtrack)	3:00
One Last Time	VIZE & R3HAB [feat. Enny-Mae]	One Last Time	2:35
One Last Time	Lin-Manuel Miranda	Hamilton (Original Broadway Cast Recording) [Explicit]	4:56
One Last Time	Ariana Grande	My Everything	3:17
One Less Bell To Answer / A House Is Not A Home (Glee Cast Version)	Glee Cast	Glee: The Music, Volume 3 Showstoppers	4:42
ONE MORE TIME	blink-182	ONE MORE TIME... [Explicit]	3:28
One of These Days	Neil Young	Harvest Moon	4:57
One Short Day (From "Wicked" Original Broadway Cast Recording/2003)	VARIOUS ARTISTS	Wicked	3:03
One Voice (Album Version)	Billy Gilman	One Voice	4:10
Only	NF	The Search	3:45
The Only Exception	Paramore	Brand New Eyes	4:27
Only Girl (In The World)	Rihanna	Loud [Explicit]	3:55
Only Takes a Moment	Bethel Music	Reckless Love	3:32
Only Us	VARIOUS ARTISTS	Dear Evan Hansen (Original Broadway Cast Recording)	3:47
Ooh Ahh (My Life Be Like) [feat. Tobymac]	Grits	The Greatest Hits	3:53
Open the Eyes of My Heart	Paul Baloche	Open the Eyes of My Heart	4:45
Opening – Oh, What A Beautiful Mornin’	VARIOUS ARTISTS	Oklahoma! (2019 Broadway Cast Recording)	3:36
Organized Chaos	MisterWives	Organized Chaos	2:56
The Other Side	VARIOUS ARTISTS	The Greatest Showman (Original Motion Picture Soundtrack)	3:34
The Other Side Of Paradise	Glass Animals	How To Be A Human Being [Explicit]	5:20
Our Lady of the Underground	Anaïs Mitchell	Hadestown (Original Broadway Cast Recording)	5:24
Our Love Is Here To Stay	Dinah Washington	After Hours With Miss D	2:30
Out of the Black	Royal Blood	Royal Blood [Explicit]	4:00
Out Of My Dreams	VARIOUS ARTISTS	Oklahoma! (2019 Broadway Cast Recording)	3:23
Out on the Weekend (2009 Remaster)	Neil Young	Harvest (2009 Remaster)	4:31
Out There	VARIOUS ARTISTS	The Hunchback of Notre Dame (Studio Cast Recording)	4:35
Out There (Remastered 2021)	VARIOUS ARTISTS	Walt Disney Records The Legacy Collection: The Hunchback of Notre Dame	5:53
Outrunning Karma	Alec Benjamin	Outrunning Karma	3:08
Over the Bannister	VARIOUS ARTISTS	Meet Me In St. Louis (Original Motion Picture Soundtrack)	1:27
Over When It's Over	Eric Church	Chief	2:39
overwhelmed	Royal & the Serpent	Overwhelmed	2:39
Paciencia Y Fe	Lin-Manuel Miranda	In the Heights (Original Broadway Cast Recording)	4:55
PAID MY DUES	NF	CLOUDS (THE MIXTAPE)	3:31
PAID MY DUES	NF	PAID MY DUES	3:31
Pain Salesmen	Prof & Ren	Pain Salesmen [Explicit]	3:19
Paint The Town Red	Doja Cat	Paint The Town Red [Clean]	3:52
Paint The Town Red	Doja Cat	Paint The Town Red [Explicit]	3:52
The Painted man	Blind Boy Music	Church Confessions	2:32
PANDEMONIUM	NF	HOPE	3:17
Papa Can You Hear Me? (Glee Cast Version)	Glee Cast	Papa Can You Hear Me? (Glee Cast Version)	3:31
Papers ("You're not from around here, son...") [Intro]	Anaïs Mitchell	Hadestown (Original Broadway Cast Recording)	1:53
Papers (Instrumental)	Anaïs Mitchell	Hadestown (Original Broadway Cast Recording)	1:13
Paris	Sabrina Carpenter	Singular Act I	3:38
Paris / Look Down	Les Misérables Cast	Les Misérables: The Motion Picture Soundtrack Deluxe (Deluxe Edition)	3:13
Part of Your World	Alan Menken, The Little Mermaid - Cast & Disney	The Little Mermaid Special Edition	3:15
Party Tattoos	dodie	Party Tattoos	3:37
Pat-A-Pan/While Shepherds Watched Their Flocks By Night (Medley / Remastered 2006)	Bing Crosby	Bing Crosby - Christmas Classics	2:52
Path of Sorrow (feat. Leslie Jordan & David Leonard)	All Sons & Daughters [feat. Leslie Jordan & David Leonard]	Poets & Saints (feat. Leslie Jordan & David Leonard)	4:27
Peace Be Still	Hope Darst	Peace Be Still	5:20
Peace On Earth / The Little Drummer Boy	VARIOUS ARTISTS	NOW That's What I Call Merry Christmas	2:36
Peaceful Valley Boulevard	Neil Young	Le Noise [+Digital Booklet]	7:09
Penelope	Pinback	Blue Screen Life	4:46
People I Don't Like	UPSAHL	Young Life Crisis [Explicit]	2:22
People of God	Gungor	Beautiful Things	4:18
People Will Say We're In Love	VARIOUS ARTISTS	Oklahoma! (2019 Broadway Cast Recording)	4:20
People Will Say We're In Love (Reprise)	VARIOUS ARTISTS	Oklahoma! (2019 Broadway Cast Recording)	1:54
Perfect	The Piano Guys	10	5:08
Perfect Illusion	Lady Gaga	Joanne [Explicit]	3:02
Perfect Someone	SOFI TUKKER	BREAD [Explicit]	4:40
Phenomenon	TobyMac	Welcome To Diverse City	5:19
Philadelphia	alt-J	The Dream [Explicit]	3:38
Phrases	Lounge Lizard Publications Limited	Learn Italian Words	18:14
Piano Sonata No. 11 in A Major, K. 331 "Turkish March": III. Alla Turca - Allegretto	VARIOUS ARTISTS	99 Must-Have Mozart Masterpieces	3:35
Piano Sonata No. 11 in A Major, K. 331, "Turkish March": III. Rondo alla Turca	VARIOUS ARTISTS	Masters of Classical Music	3:43
Piece Of Your Heart	Meduza & GOODBOYS	Piece Of Your Heart	2:33
Pieces (with VIZE & Leony)	AVAION, VIZE & Leony	Pieces (with VIZE & Leony)	2:53
Pink Pony Club	Chappell Roan	The Rise and Fall of a Midwest Princess [Explicit]	4:18
Piragua	Lin-Manuel Miranda	In the Heights (Original Broadway Cast Recording)	1:53
Piragua (Reprise)	Lin-Manuel Miranda	In the Heights (Original Broadway Cast Recording)	0:52
Pirates of the Caribbean	2Cellos	Let There Be Cello	3:00
Pit Bull Anthem	Dj Memory, Fonzie Ciaco, DJ Fonzie & DJ Ciaco	Pit Bull Anthem	5:45
Pit Bull Anthem (Alonso Chavez Radio Edit)	Dj Memory, Fonzie Ciaco, DJ Fonzie & DJ Ciaco	Pit Bull Anthem	3:30
Pit Bull Anthem (Cyako Traxx Remix)	Dj Memory, Fonzie Ciaco, DJ Fonzie & DJ Ciaco	Pit Bull Anthem	5:13
Pit Bull Anthem (DJ Fonzies Choco Radio Edit)	Dj Memory, Fonzie Ciaco, DJ Fonzie & DJ Ciaco	Pit Bull Anthem	3:49
Pit Bull Anthem (FON21 Remix)	Dj Memory, Fonzie Ciaco, DJ Fonzie & DJ Ciaco	Pit Bull Anthem	6:16
Pit Bull Anthem (Pit Bull Team Radio Edit)	Dj Memory, Fonzie Ciaco, DJ Fonzie & DJ Ciaco	Pit Bull Anthem	3:10
The Plagues	VARIOUS ARTISTS	The Prince Of Egypt (Music From The Original Motion Picture Soundtrack)	2:40
Play	K-391, Alan Walker & Martin Tungevaag [feat. Mangoo]	Play	2:48
Play Hard (feat. Ne-Yo & Akon)	David Guetta	Nothing but the Beat 2.0 [Explicit]	3:21
Play It In My Head	VARIOUS ARTISTS	Kipo And The Age Of Wonderbeasts (Season 2 Mixtape)	1:11
Playing With The Big Boys	VARIOUS ARTISTS	The Prince Of Egypt (Music From The Original Motion Picture Soundtrack)	2:52
Please Be My Strength	Gungor	Beautiful Things	3:32
Pocketful of Sunshine	Natasha Bedingfield	Pocketful Of Sunshine	3:22
Poetically Correct	TobyMac	Welcome To Diverse City	0:56
Poker Face (Glee Cast Version)	Glee Cast	Glee: The Music, Volume 3 Showstoppers	3:39
Poldark - Main Theme	Geek Music	Poldark - Main Theme	1:31
Polonaise in A-Flat Major, Op. 53 "Heroic Polonaise"	Marián Pivka, Peter Frankl, Oliver von Dohnanyi & Slovak Philharmonic Orchestra	Blue Edition - Chopin: "Heroic Polonaise" & Piano Concerto No. 2, Op. 21	6:28
Pool Mashup: Just The Way You Are/Just A Dream	VARIOUS ARTISTS	Ultimate Pitch Perfect (Original Motion Picture Soundtrack)	1:38
Poor Unfortunate Souls	Alan Menken, The Little Mermaid - Cast & Disney	The Little Mermaid Special Edition	4:51
Popular (From "Wicked" Original Broadway Cast Recording/2003)	VARIOUS ARTISTS	Wicked	3:44
Pore Jud Is Daid	VARIOUS ARTISTS	Oklahoma! (2019 Broadway Cast Recording)	4:28
Pork Soda	Glass Animals	How To Be A Human Being [Explicit]	4:13
Posin (Club Mix)	Glenn Gatsby	Posin	4:54
Potato Song (Cuz I Want To)	Kesha	High Road [Explicit]	3:33
Powders	alt-J	The Dream [Explicit]	4:41
Power	Ren	Power [Explicit]	3:25
The Prayer	Danny Gokey & Natalie Grant	The Prayer	4:31
Prayer in C (Robin Schulz Radio Edit)	Lillywood & Robin Schulz	Prayer In C	3:09
Praying	Kesha	Rainbow [Explicit]	3:50
Praying	Kesha	Rainbow [Explicit]	3:50
Pressing On	Relient K	The Anatomy of the Tongue in Cheek	3:29
PRIDEFUL	NF	CLOUDS (THE MIXTAPE)	3:26
Prince Ali (Reprise)	VARIOUS ARTISTS	Aladdin (Original Motion Picture Soundtrack)	1:07
Problem [feat. Iggy Azalea]	Ariana Grande	My Everything	3:13
Prologue (Love Never Dies)	Andrew Lloyd Webber	Love Never Dies	4:10
Prologue / Look Down (Live)	Claude-Michel Schönberg & Alain Boublil	Les Misérables Live! (2010 London Cast Recording)	9:13
Prologue: Into the Woods	VARIOUS ARTISTS	Into the Woods (Original Motion Picture Soundtrack)	14:35
Prologue: Into The Woods	Original Broadway Cast of Into the Woods	Into the Woods (Original Broadway Cast Recording)	11:58
Prologue: So Happy	Original Broadway Cast of Into the Woods	Into the Woods (Original Broadway Cast Recording)	3:49
Promiscuous [feat. Timbaland]	Nelly Furtado	Loose	4:02
Promises	Anaïs Mitchell	Hadestown (Original Broadway Cast Recording)	2:43
Promises	Maverick City Music	Maverick City Vol. 3 Part 1	10:46
The Proof of Your Love	for KING & COUNTRY	Crave	3:17
The Proof Of Your Love (The Monologue Mix)	for KING & COUNTRY	The Proof Of Your Love (The Monologue Mix)	3:41
Protector (Live)	Kim Walker-Smith	Wild Heart	6:48
PROVENZA	Karol G	PROVENZA	3:30
PROVENZA	Karol G	MAÑANA SERÁ BONITO [Explicit]	3:28
Purple Jaguar Eye	VARIOUS ARTISTS	Kipo And The Age Of Wonderbeasts (Season 1 Mixtape) [Clean]	1:52
Push The Feeling On (Mk Dub Revisited Edit)	Nightcrawlers	Push The Feeling On	4:03
Push It! (Remix)	Lotus, Spyzr, Salt-N-Pepa	Push It!	2:53
Push Off	The Palms	The Palms - EP [Explicit]	3:51
Put Me Back Together (feat. Kiiara)	Cheat Codes [feat. Kiiara]	Put Me Back Together (feat. Kiiara) [Explicit]	3:43
Put Your Records On	Ritt Momney	Put Your Records On	3:30
Putariazinha	Felipe Amorim	Putariazinha [Explicit]	2:42
queen of broken hearts	blackbear	everything means nothing [Explicit]	2:51
Quiet Storm (Interlude)	TobyMac	Momentum	0:34
Quietly Yours	Birdy & Stuart Earl	Persuasion (Soundtrack from the Netflix Film)	3:54
Quit Playing Games (With My Heart)	Backstreet Boys	Backstreet Boys	3:53
Rabbit Heart (Raise It Up)	Florence + The Machine	Lungs	3:52
Rain Man Theme	2Cellos	Score	4:41
Rainbow	Kesha	Rainbow [Explicit]	3:38
Raindrop Waltz No. 1 in B Minor	Joshua Kyan Aalampour	Raindrop Waltz No. 1 in B Minor	0:57
Raise a Hallelujah (Studio Version)	Bethel Music, Jonathan David Helser & Melissa Helser	Raise a Hallelujah (Studio Version) (Single)	4:04
Raise It Up	August Rush (Motion Picture Soundtrack)	August Rush (Soundtrack)	2:26
RATTLE! (Live)	Elevation Worship	Graves Into Gardens (Deluxe) [Live]	7:12
Ready Or Not (Radio Edit)	Cascada	Evacuate The Dancefloor	3:00
Ready Set Roll	Chase Rice	Ignite the Night (Party Edition) [Explicit]	3:10
The Real Slim Shady	Eminem	The Marshall Mathers LP [Explicit]	4:44
Real Thing	Turnstile	Time & Space	1:56
Reception At The Palace / So This Is Love	VARIOUS ARTISTS	Cinderella	5:44
Reckless Love	Bethel Music	Reckless Love	5:33
Record Player	Daisy the Great & AJR	Record Player	2:29
Red Hands	Walk Off the Earth	R.E.V.O.	3:00
Refiner	Maverick City Music	Maverick City Vol. 2	12:12
Reflection	Mulan - Cast & Disney	Mulan (Original Soundtrack)	2:26
Reindeer(s) Are Better Than People (Cont.)	VARIOUS ARTISTS	Frozen 2 (Original Motion Picture Soundtrack)	0:26
Reptilia	The Strokes	Room On Fire	3:39
Requiem	VARIOUS ARTISTS	Dear Evan Hansen (Original Broadway Cast Recording)	4:19
Requiem for a Dream	Jennifer Thomas	Illumination	3:33
Requiem For A Tower	Escala	Escala	1:59
The Resistance	2Cellos	2CELLOS	3:49
Rest In You	All Sons & Daughters [feat. Leslie Jordan & David Leonard]	The All Sons & Daughters Collection (feat. Leslie Jordan & David Leonard)	5:04
Rest In You (feat. Leslie Jordan & David Leonard)	All Sons & Daughters [feat. Leslie Jordan & David Leonard]	Poets & Saints (feat. Leslie Jordan & David Leonard)	5:04
Rest of My Life	Nickel Creek	A Dotted Line	3:39
resume	bbno$	eat ya veggies [Explicit]	2:44
Revolution	The Score	ATLAS [Explicit]	3:52
Rewrite the Stars	The Piano Guys	Rewrite the Stars	3:31
Rewrite the Stars	The Piano Guys	Limitless	3:31
Rewrite The Stars	VARIOUS ARTISTS	The Greatest Showman (Original Motion Picture Soundtrack)	3:37
The Reynolds Pamphlet	Lin-Manuel Miranda	Hamilton (Original Broadway Cast Recording) [Explicit]	2:08
Rhapsody in Blue	Leonard Bernstein	Gershwin: Rhapsody in Blue & An American in Paris - Grofé: Grand Canyon Suite	16:24
Richter: Vladimir's Blues	Max Richter	The Blue Notebooks (15 Years)	1:19
Ride	twenty one pilots	Blurryface	3:34
Riff Off (From "Pitch Perfect 2" Soundtrack)	VARIOUS ARTISTS	Pitch Perfect 2 - Special Edition (Original Motion Picture Soundtrack)	4:24
Riff Off: Mickey/Like A Virgin/Hit Me With Your Best Shot/S&M/Let’s Talk About Sex/I’ll Make Love To You/Feels Like The First Time/No Diggity	VARIOUS ARTISTS	Ultimate Pitch Perfect (Original Motion Picture Soundtrack)	3:44
Right Hand Man	Lin-Manuel Miranda	Hamilton (Original Broadway Cast Recording) [Explicit]	5:21
Right on Time (feat. Tobymac)	Aaron Cole [feat. TobyMac]	Right on Time (feat. Tobymac)	3:19
Right Round	Flo Rida	R.O.O.T.S. (Route of Overcoming the Struggle) (Explicit Amazon Exclusive) [Explicit]	3:24
Rise Up	Imagine Dragons	Evolve	3:51
Ritual Dance	August Rush (Motion Picture Soundtrack)	August Rush (Soundtrack)	1:33
River	Bishop Briggs	Bishop Briggs	3:34
The River	Jordan Feliz	Beloved	3:15
River Lullaby	VARIOUS ARTISTS	The Prince Of Egypt (Music From The Original Motion Picture Soundtrack)	3:56
River of Fire	In This Moment	Ritual [Explicit]	3:58
Road to Hell	Anaïs Mitchell	Hadestown (Original Broadway Cast Recording)	5:17
Road to Hell (Reprise)	Anaïs Mitchell	Hadestown (Original Broadway Cast Recording)	5:05
The Robbery	Les Misérables Cast	Les Misérables: The Motion Picture Soundtrack Deluxe (Deluxe Edition)	2:51
Rock My Body	R3HAB, INNA & Sash!	Rock My Body	2:17
Rockabye (feat. Sean Paul & Anne-Marie)	Clean Bandit [feat. Sean Paul & Anne-Marie]	Rockabye (feat. Sean Paul & Anne-Marie)	4:11
Rockin' Around The Christmas Tree (Remastered 2007)	Amy Grant	Home For Christmas	2:08
Rockstar	Nickelback	All the Right Reasons	4:15
Rollin' (The Ballad of Big & Rich)	Big & Rich	Horse of a Different Color	4:50
Rolling Dice	Just A Gent	Stories to Tell	4:47
Rolling In The Deep (Glee Cast Version Featuring Jonathan Groff)	Glee Cast	Glee: The Music, Volume 6	3:25
The Room Where It Happens	Lin-Manuel Miranda	Hamilton (Original Broadway Cast Recording) [Explicit]	5:18
Roots	In This Moment	Ritual [Explicit]	4:09
Rose's Turn (Glee Cast Version)	Glee Cast	Glee: The Music, Volume 3 Showstoppers	2:00
Roses (Imanbek Remix)	Saint Jhn	Roses (Imanbek Remix) [Explicit]	2:56
roslyn (slowed + reverb)	ghostly echoes, Creamy & 11:11 Music Group	roslyn (slowed + reverb)	3:32
ROXANNE	Arizona Zervas	ROXANNE [Explicit]	2:43
Rude Boy	Rihanna	Rated R [Explicit]	3:42
Rudolph The Red Nosed Reindeer	VARIOUS ARTISTS	Christmas Factor, Vol. 7	2:30
Rudolph The Red Nosed Reindeer	VARIOUS ARTISTS	Christmas Celebrations, Vol. 1	2:30
Rudolph The Red-Nosed Reindeer	Bing Crosby	Bing Crosby - Christmas Classics	2:15
Rudolph the Red-Nosed Reindeer	Gene Autry	Rudolph The Red Nosed Reindeer And Other Christmas Classics	3:09
Rudolph The Red-Nosed Reindeer	Bing Crosby	That Christmas Feeling	2:16
Rule the World	Walk Off the Earth	Sing It All Away	3:25
Rumblin'	Neil Young	Le Noise [+Digital Booklet]	3:36
Rumour Has It / Someone Like You	Glee Cast	Glee: The Music, Volume 7	3:27
Run Away to Mars	Talk	Run Away to Mars	3:34
Run Away with You	Big & Rich	Gravity	3:44
Run This Town [feat. Rihanna & Kanye West]	Jay-Z	The Hits Collection Volume One [Explicit]	4:28
Run to You  (LoFi)	Ocie Elliott & Nathan Kawanishi	Run to You (LoFi)	2:40
Run Wild.	for KING & COUNTRY	RUN WILD. LIVE FREE. LOVE STRONG. (Deluxe Anniversary Edition)	4:01
Run Wild. (feat. Andy Mineo)	for KING & COUNTRY	RUN WILD. LIVE FREE. LOVE STRONG.	4:01
Run the World (Girls)	Beyoncé	4	3:56
Runaway 	Ramin Djawadi	Westworld: Season 2 (Music From the HBO Series)	2:48
RUNNING	NF	HOPE	4:14
Running For So Long (House A Home)	VARIOUS ARTISTS	The Peanut Butter Falcon (Original Motion Picture Soundtrack)	4:33
Running with the Wolves	AURORA	All My Demons Greeting Me as a Friend (Deluxe)	3:14
Running With The Wolves	VARIOUS ARTISTS	Eurovision Song Contest: The Story of Fire Saga (Music from the Netflix Film)	1:10
The Russian And Molokov / Where I Want To Be	VARIOUS ARTISTS	Chess (The Original Recording / Remastered / Deluxe Edition)	6:23
S.O.S. (Sawed Off Shotgun)	The Glorious Sons	S.O.S. (Sawed Off Shotgun) [Explicit]	3:15
S&M	Rihanna	Loud [Explicit]	4:03
SAD (Imanbek xxx Remix)	Rasster & Erin Bloomer	SAD (Imanbek xxx Remix) [Explicit]	2:55
SAD!	XXXTentacion	? [Explicit]	2:46
Sadie Hawkins Dance	Relient K	The Anatomy of the Tongue in Cheek	2:57
Safe & Sound	William Joseph	Safe & Sound	4:01
Same Old Love	VARIOUS ARTISTS	NOW That's What I Call Music!, Vol. 60 (Deluxe Edition)	3:47
Same Old Love	Selena Gomez	Revival (Deluxe) [Explicit]	3:49
Sandstorm (Radio Edit)	Darude	Sandstorm	3:46
Santa Claus Is Comin' To Town (1990 - Remaster)	VARIOUS ARTISTS	Christmas Kisses	2:46
Santa Claus Is Coming to Town	VARIOUS ARTISTS	Merry Xmas & Happy New Year! ...50 Songs	2:34
Satisfied	Jordan Feliz	The River	3:41
Satisfied	Lin-Manuel Miranda	Hamilton (Original Broadway Cast Recording) [Explicit]	5:29
Savage	Bahari	Savage	2:44
Savage Daughter	Sarah Hester Ross	Savage Daughter	2:58
Save the Last Dance for Me	Michael Bublé	It's Time	3:39
Saved	Big & Rich	Horse of a Different Color	4:51
Say Amen (Saturday Night)	Panic! At The Disco	Pray for the Wicked [Explicit]	3:09
Say It	The Syndicate	Sounds of Syndication, Vol. 2 (Presented by Syndicate)	4:19
Say It (feat. Tove Lo)	Flume	Skin [Explicit]	4:22
Say It (Illenium Remix)	Flume & Illenium [feat. Tove Lo]	Say It (Illenium Remix) [Explicit]	4:27
Say My Name	David Guetta	7 [Explicit]	3:18
Say My Name	Destiny's Child	The Writing's On The Wall	4:31
Say No to This	Lin-Manuel Miranda	Hamilton (Original Broadway Cast Recording) [Explicit]	4:02
Say Something	Justin Timberlake	Man of the Woods [Explicit]	4:38
Say Something	A Great Big World	Is There Anybody Out There?	3:49
Saying Goodnight	VARIOUS ARTISTS	Meet Me In St. Louis (Original Motion Picture Soundtrack)	3:32
Scarlemagne's Waltz	VARIOUS ARTISTS	Kipo And The Age Of Wonderbeasts (Season 1 Mixtape) [Clean]	0:48
Scars	I AM THEY	Trial & Triumph	3:58
Schindler's List Main Theme	2Cellos	Score	4:21
Schuyler Defeated	Lin-Manuel Miranda	Hamilton (Original Broadway Cast Recording) [Explicit]	1:03
Scooter Skunks	VARIOUS ARTISTS	Kipo And The Age Of Wonderbeasts (Season 3 Mixtape)	0:53
Scotch & Chocolate	Nickel Creek	Why Should The Fire Die?	3:07
The Search	NF	The Search	4:08
Seasons	Bebe Rexha	Bebe [Explicit]	3:23
Seavolution (From Hotel Transylvania 3)	Tiësto	Hotel Transylvania 3	2:01
A Second Chance	VARIOUS ARTISTS	Kipo And The Age Of Wonderbeasts (Season 3 Mixtape)	0:33
Second Chance	Shinedown	The Sound of Madness	3:42
See a Victory (Studio)	Elevation Worship	At Midnight - EP	4:15
A Sentimental Man (From "Wicked" Original Broadway Cast Recording/2003)	VARIOUS ARTISTS	Wicked	1:16
Señorita	Shawn Mendes & Camila Cabello	Señorita	3:11
Serotonin	girl in red	if i could make it go quiet [Explicit]	3:02
Set Me Free	The Chicks	Gaslighter [Explicit]	3:19
Setting the World On Fire	Kenny Chesney	Cosmic Hallelujah	3:37
Seven Bridges Road (Album Version)	Ricochet	What You Leave Behind	3:07
Seven Devils	Florence + The Machine	Ceremonials (Deluxe Edition)	5:03
Seven Nation Army	2Cellos	Seven Nation Army	2:40
Seventeen (Electro Swing Spin)	Glenn Gatsby & Luke & The Belleville Orchestra	Seventeen (Electro Swing Spin)	3:00
The Sewers	Les Misérables Cast	Les Misérables: The Motion Picture Soundtrack Deluxe (Deluxe Edition)	2:23
Sexy Bitch (feat. Akon)	David Guetta	One Love (Deluxe)	3:15
Shake It Out	Florence + The Machine	Shake It Out (EP)	4:38
Shake It Out	Florence + The Machine	Ceremonials (Deluxe Edition)	4:37
Shakedown	The Score	ATLAS [Explicit]	3:25
Shameless	Camila Cabello	Romance [Explicit]	3:39
Shameless	Camila Cabello	Shameless	3:39
She Burns	Foy Vance	The Wild Swan	3:49
She Wants Me (To Be Loved)	The Happy Fits	What Could Be Better	3:19
She's In Love With The Boy (Single Version)	Trisha Yearwood	Trisha Yearwood	4:08
Shiny	VARIOUS ARTISTS	Moana (Original Motion Picture Soundtrack)	3:05
Ship in a Bottle	fin	Lost at Sea	5:14
Ship To Wreck	Florence + The Machine	How Big, How Blue, How Beautiful (Deluxe)	3:54
Shivering	Illenium & Spiritbox	Shivering	5:01
Shivers (Ofenbach Remix)	Ed Sheeran	Shivers (Ofenbach Remix)	3:07
Short Change Hero	The Heavy	The House That Dirt Built	5:22
Shoulders	for KING & COUNTRY	RUN WILD. LIVE FREE. LOVE STRONG. (Deluxe Anniversary Edition)	5:03
Show Me the Meaning of Being Lonely	Backstreet Boys	Millennium	3:54
Show Pony	Glass Animals	I Love You So F***ing Much [Explicit]	4:16
Show Yourself	VARIOUS ARTISTS	Frozen 2 (Original Motion Picture Soundtrack)	4:20
Shut Eye	Stealing Sheep	Into the Diamond Sun	2:53
Shut Up And Drive	Rihanna	Good Girl Gone Bad: Reloaded	3:32
Side To Side [feat. Nicki Minaj]	VARIOUS ARTISTS	Best Of 2017 [Explicit]	3:46
Sign Of Love	Neil Young	Le Noise [+Digital Booklet]	3:55
Silence	Marshmello [feat. Khalid]	Silence	3:00
Silent Night	VARIOUS ARTISTS	Waiting For Surprise, Vol. 1	3:04
Silent Night	2Cellos	Silent Night	2:28
Silent Night	Tommee Profitt	The Birth Of A King	4:55
Silent Night	The Piano Guys	A Family Christmas	3:30
Silk	Elijah Blond	Silk [Explicit]	2:15
Silver Bells	VARIOUS ARTISTS	Christmas Celebrations, Vol. 1	3:04
Silver Bells [feat. Carol Richards]	Bing Crosby	White Christmas	3:02
Simple Romance	Coin	Dreamland	3:14
Simple Things	Maya Jane Coles	What They Say EP	7:41
Sincerely, Me	VARIOUS ARTISTS	Dear Evan Hansen (Original Broadway Cast Recording)	3:43
Single Ladies (Put a Ring on It)	Beyoncé	I AM...SASHA FIERCE	3:13
Six Foot Town	Big & Rich	Horse of a Different Color	3:47
Skin and Bones	David Kushner	Skin and Bones	3:35
Skip to My Lou	VARIOUS ARTISTS	Meet Me In St. Louis (Original Motion Picture Soundtrack)	2:27
Sky Full Of Song	Florence + The Machine	High As Hope [Explicit]	3:46
The Slam	TobyMac	Welcome To Diverse City	3:19
Sleep at Night	The Chicks	Gaslighter [Explicit]	3:13
Sleep Forever	Portugal. The Man	In the Mountain in the Cloud [Explicit]	6:20
The Sleeping Beauty, Op. 66, Act I "The Spell": No. 9, Finale	André Previn	Tchaikovsky: The Sleeping Beauty, Op. 66	7:36
The Sleeping Beauty, Op. 66, Act III "The Wedding": No. 24, Pas de caractère. Puss-in-Boots and the White Cat	André Previn	Tchaikovsky: The Sleeping Beauty, Op. 66	1:53
The Sleeping Beauty, Op. 66, Prologue "The Christening": No. 4, Finale	André Previn	Tchaikovsky: The Sleeping Beauty, Op. 66	8:34
Sleigh Ride	Bing Crosby	The Voice Of Christmas - The Complete Decca Christmas Songbook	2:44
Slow Down	Gone West	Canyons	3:52
Slow It Down	The Lumineers	The Lumineers	5:07
Slow Sipper	The Dip	Slow Sipper	3:00
Smells Like Teen Spirit	2Cellos	2CELLOS	2:50
Smells Like Teen Spirit	Saint Mesa	Smells Like Teen Spirit	4:11
Smile	Madeleine Peyroux	Keep Me In Your Heart For A While: The Best Of Madeleine Peyroux	4:01
Smoke A Little Smoke	Eric Church	Carolina	3:11
Smokestack Lightnin'	VARIOUS ARTISTS	The Vietnam War - A Film By Ken Burns & Lynn Novick (The Soundtrack)	3:07
Smooth Criminal	2Cellos	2CELLOS	4:10
Smooth Criminal (Glee Cast Version)	Glee Cast [feat. 2Cellos]	Smooth Criminal (Glee Cast Version)	3:34
The Snake Song (Album Version)	Billy Gilman	One Voice	3:11
Snowfall	Doris Day	The Doris Day Christmas Album	3:25
So Alive	Goo Goo Dolls	Boxes	3:15
So American	Portugal. The Man	In the Mountain in the Cloud [Explicit]	3:35
So Big / So Small	VARIOUS ARTISTS	Dear Evan Hansen (Original Broadway Cast Recording)	4:12
So Good (Orchestral Version / Amazon Original)	Halsey	So Good (Orchestral Version / Amazon Original)	3:08
So Will I (100 Billion X)	Hillsong UNITED	Wonder	6:51
Soldier	Tommee Profitt	Cinematic Songs (Vol. 1)	3:45
Soldier (2017 Remaster)	Neil Young	Decade	2:29
Soldier, Poet, King	The Oh Hellos	Dear Wormwood	2:45
A Solemn Music	Boston Modern Orchestra Project, Gil Rose, Thomas Meglioranza, Kristen Watson	Virgil Thomson: Three Pictures	6:46
Solitary Ground	Epica	Consign To Oblivion (Expanded Edition)	4:24
Solitude	Ella Fitzgerald & Duke Ellington And His Orchestra	Ella Fitzgerald Sings The Duke Ellington Songbook (Expanded Edition)	2:08
Some Things Never Change	VARIOUS ARTISTS	Frozen 2 (Original Motion Picture Soundtrack)	3:29
Somebody More Like You	Nickel Creek	Why Should The Fire Die?	3:01
Somebody That I Used to Know	Walk Off the Earth	Somebody That I Used to Know	4:08
Somebody That I Used to Know	Walk Off the Earth	R.E.V.O.	4:08
Somebody That I Used To Know (Glee Cast Version)	Glee Cast	Somebody That I Used To Know (Glee Cast Version)	4:06
Somebody's Watching	TobyMac	Momentum	3:15
Someday (From the August Rush Soundtrack)	August Rush (Motion Picture Soundtrack)	August Rush (Soundtrack)	3:03
Someone Else	REZZ & Grabbitz	Someone Else	3:18
Someone Else's Story	VARIOUS ARTISTS	Chess In Concert	3:39
Someone You Loved	Lewis Capaldi	Breach [Explicit]	3:02
Someone's Gonna Rescue You	Neil Young	Le Noise [+Digital Booklet]	3:26
Something Bad (From "Wicked" Original Broadway Cast Recording/2003)	VARIOUS ARTISTS	Wicked	1:39
Something Has To Break (Live)	Kierra Sheard	KIERRA	6:42
Something I Can Never Have	Ramin Djawadi	Westworld: Season 1 (Music from the HBO Series)	5:56
Something Just Like This / Hungarian Rhapsody	The Piano Guys	Something Just Like This / Hungarian Rhapsody	3:53
Something Stupid (feat. Reese Witherspoon)	Michael Bublé	To Be Loved	2:57
Something There	VARIOUS ARTISTS	Beauty and the Beast	2:19
Somewhere Only We Know	Keane	The Best Of Keane (Deluxe Edition)	3:56
Song About You	Mike Posner	A Real Good Kid [Explicit]	3:10
The Song of the White Wolf	Dan Vasc [feat. Gabriel Belozi]	The Song of the White Wolf	3:39
Songbird	Glee Cast	Glee: The Music, Volume 6	3:18
Sorry Not Sorry	Demi Lovato	Tell Me You Love Me [Clean]	3:23
Sorry Not Sorry	Demi Lovato	Tell Me You Love Me (Deluxe) [Clean]	3:23
Sorry Not Sorry	Demi Lovato	Tell Me You Love Me (Deluxe) [Clean]	3:23
Soul Fever Blues	Parov Stelar	The Burning Spider	3:05
Soul Of A Woman	Neil Young International Harvesters	A Treasure	4:26
Soul Shaker	Big & Rich	Comin' to Your City	3:05
Soulmate	Lizzo	Cuz I Love You (Deluxe) [Explicit]	2:55
The Sound of Silence	Disturbed	Immortalized (Deluxe Edition) [Explicit]	4:08
The Sound of Silence (Live on CONAN)	Disturbed	The Sound of Silence (Live on CONAN)	4:13
South of the Border (feat. Camila Cabello & Cardi B)	Ed Sheeran	No.6 Collaborations Project [Explicit]	3:24
Southerly Change	Mitch King	Southerly Change	6:09
Southern Man (2017 Remaster)	Neil Young	Decade	5:29
Southern Pacific	Neil Young International Harvesters	A Treasure	7:51
Space Ghost Coast To Coast	Glass Animals	Dreamland [Explicit]	3:07
Spaceship	Kesha	Rainbow [Explicit]	5:15
Spanish Podcast: Basics for Absolute Beginners, Pt. 4	Carolia Spanish Languagetalk	Learning Spanish Podcast: Basics for Absolute Beginners (Carolia Season 1, Episode 1)	0:44
Spark	Amber Run	5AM (Expanded Edition)	3:49
Spicy Margarita (feat. Maria Becerra)	Jason Derulo & Michael Bublé [feat. Maria Becerra]	Spicy Margarita (feat. Maria Becerra)	2:34
Spirit Break Out (Live)	Kim Walker-Smith	Still Believe (Live)	6:22
SPLAT	Connor Price	SPLAT	2:06
Stand By Me	Ben E. King	The Very Best of Ben E. King	2:55
Stand By Me	Florence + The Machine	Songs From Final Fantasy XV	4:05
Stand In Your Love (Radio Version)	Bethel Music & Josh Baldwin	Stand In Your Love (Radio Version)	3:41
Star of Bethlehem (2016 Remaster)	Neil Young	American Stars 'N Bars	2:42
Stars	Les Misérables Cast	Les Misérables: The Motion Picture Soundtrack Deluxe (Deluxe Edition)	2:45
Stars Tonight	Zeds Dead & Droeloe	Stars Tonight	2:53
Stars Were Gleaming	Jon Schmidt	Jon Schmidt Christmas	3:48
Start Over (feat. NF)	Flame	Royal Flush	3:16
Start a Riot	VARIOUS ARTISTS	Spider-Man: Into the Spider-Verse (Soundtrack From & Inspired by the Motion Picture)	2:51
Stay	Zedd & Alessia Cara	Stay	3:30
Stay Alive	Lin-Manuel Miranda	Hamilton (Original Broadway Cast Recording) [Explicit]	2:39
Stay Alive (Reprise)	Lin-Manuel Miranda	Hamilton (Original Broadway Cast Recording) [Explicit]	1:51
Stay Awake (From "Mary Poppins"/Soundtrack Version)	VARIOUS ARTISTS	Mary Poppins	1:45
Stay Away (feat. Machine Gun Kelly & Goody Grace)	Mod Sun [feat. Machine Gun Kelly & Goody Grace]	Stay Away (feat. Machine Gun Kelly & Goody Grace) [Explicit]	2:31
Stay With Me	Original Broadway Cast of Into the Woods	Into the Woods (Original Broadway Cast Recording)	2:42
Stay With Me	VARIOUS ARTISTS	Into the Woods (Original Motion Picture Soundtrack)	3:14
Stay, I Pray You	VARIOUS ARTISTS	Anastasia (Original Broadway Cast Recording)	3:26
Steady as the Beating Drum	VARIOUS ARTISTS	Pocahontas	1:46
Still God	Elevation Worship	Hallelujah Here Below	4:26
Still Hurting	Jason Robert Brown	The Last Five Years (2013 Off-Broadway Cast Recording)	5:05
Still In Control	Mack Brock	Covered	4:58
Still Not Over You	Klyne	Klyne	3:49
Still Rolling Stones	Lauren Daigle	Look Up Child	4:08
Still, Still, Still	The Piano Guys	A Family Christmas	4:59
Stitches (Instrumental Version)	Soft Background Music	Latest Music - Pop Music on Piano	3:25
Stockholm Syndrome	blink-182	blink-182 [Explicit]	2:41
Stockholm Syndrome Interlude	blink-182	blink-182 [Explicit]	1:40
Stolen Dance	Milky Chance	Sadnecessary (Bonus Track Version)	5:14
Stolen Love	Josiah and the Bonnevilles	Stolen Love	3:43
Stonecutters	Dope Lemon	Honey Bones [Explicit]	4:30
Stones (Live)	Kim Walker-Smith	Wild Heart	6:48
Stories (Down To The Bottom)	TobyMac	Welcome To Diverse City	4:40
Stormy Weather	Billie Holiday	The Complete Billie Holiday On Verve 1945 - 1959	3:41
STORY	NF	CLOUDS (THE MIXTAPE)	4:40
The Story I'll Tell	Maverick City Music	Maverick City, Vol. 3 Pt. 2	7:15
The Story of Tonight	Lin-Manuel Miranda	Hamilton (Original Broadway Cast Recording) [Explicit]	1:32
The Story of Tonight (Reprise)	Lin-Manuel Miranda	Hamilton (Original Broadway Cast Recording) [Explicit]	1:55
Strange	Celeste	Not Your Muse (Deluxe)	4:16
Stranger	Can't Swim	Fail You Again	3:57
Street Urchins	VARIOUS ARTISTS	Aladdin (Original Motion Picture Soundtrack)	1:52
Strip That Down [feat. Quavo]	VARIOUS ARTISTS	Best Of 2017 [Explicit]	3:24
Stronger	The Score	Pressure [Clean]	3:11
Stronger	The Score	Pressure [Clean]	3:11
STRUT	EMELINE	STRUT [Explicit]	1:58
Stubborn Love	The Lumineers	The Lumineers	4:39
Stumptown	Nickel Creek	Why Should The Fire Die?	1:44
Stupid Deep	Jon Bellion	Glory Sound Prep [Explicit]	2:58
Submarines	The Lumineers	The Lumineers	2:43
Such a Woman	Neil Young	Harvest Moon	4:37
Sucker For Pain (with Logic, Ty Dolla $ign & X Ambassadors)	VARIOUS ARTISTS	Suicide Squad: The Album [Explicit]	4:04
Suddenly	Les Misérables Cast	Les Misérables: The Motion Picture Soundtrack Deluxe (Deluxe Edition)	2:32
Suddenly (Reprise)	Les Misérables Cast	Les Misérables: The Motion Picture Soundtrack Deluxe (Deluxe Edition)	0:54
Sugar Mountain (2017 Remaster)	Neil Young	Decade	5:45
Summer Chronicles	Sweatson Klank	Embers	2:42
Summer Samba (So Nice)	Astrud Gilberto	Talkin' Verve	2:43
Summertime	Ella Fitzgerald & Louis Armstrong	The Complete Ella And Louis On Verve	4:59
Sun Comes Up	Timmy Trumpet & Sam Feldt [feat. Joe Taylor & Ekko]	Sun Comes Up	2:21
Sunny Day	MR TOUT LE MONDE	SUN	3:12
Sunrise	Lin-Manuel Miranda	In the Heights (Original Broadway Cast Recording)	4:08
Sunroof	VARIOUS ARTISTS	Pop Summer Hits 2024 [Explicit]	2:43
Sunroof (Loud Luxury Remix)	Nicky Youre & dazy	Sunroof (Remixes)	2:54
Sunset Lover	Petit Biscuit	Petit Biscuit	3:58
Surface Pressure	Lin-Manuel Miranda, Germaine Franco & Encanto - Cast	Encanto (Original Motion Picture Soundtrack)	3:22
The Surrey With The Fringe On Top	VARIOUS ARTISTS	Oklahoma! (2019 Broadway Cast Recording)	5:18
Survivor	Destiny's Child	Survivor	4:14
Swan Lake, Op.20, Act II: 14. Scene (Moderato)	André Previn/London Symphony Orchestra	Tchaikovsky: Swan Lake	3:00
Sway With Me	VARIOUS ARTISTS	Birds of Prey: The Album [Explicit]	2:48
Sweater Weather	The Neighbourhood	I Love You. [Explicit]	4:00
Sweet Disposition	The Temper Trap	Conditions	3:50
Sweet Dreams	Beyoncé	I AM...SASHA FIERCE	3:28
Sweet Dreams (Are Made Of This)	REZZ & Fknsyd	Sweet Dreams (Are Made Of This)	2:34
Sweet Nothing	Calvin Harris	18 Months [Explicit]	3:32
Sweet Something	Will Magid & Alligator Spacewalk	Alligator Spacewalk	3:45
A Symptom Of Being Human (Acoustic Remix)	Shinedown	A Symptom Of Being Human (Acoustic Remix)	4:11
Taekwondo	Walk Off the Earth	Taekwondo (Original Motion Picture Soundtrack)	3:46
Taekwondo (Acoustic)	Walk Off the Earth	Taekwondo (Original Motion Picture Soundtrack)	3:08
Take a Break	Lin-Manuel Miranda	Hamilton (Original Broadway Cast Recording) [Explicit]	4:46
Take It All Back 2.0	Judah & the Lion	Folk Hop n' Roll (Deluxe)	3:38
Take Me to Paris	Elizabeth Swados	The Liz Swados Project	2:22
Take Me to War (Live)	The Crane Wives	Take Me to War (Live)	3:41
Take A Slice	Glass Animals	How To Be A Human Being [Explicit]	3:49
Take Some Time (Gus alt-J Remix)	Wilderado [feat. alt-J]	Take Some Time (Gus alt-J Remix)	4:11
Take You To Rio	VARIOUS ARTISTS	Rio: Music From The Motion Picture	3:26
Takeaway	The Chainsmokers	World War Joy [Explicit]	3:30
Taking Over	Joe Goddard	Taking Over	5:36
Tangerine	Glass Animals	Dreamland [Explicit]	3:20
Tango Del Fuego	Parov Stelar	Voodoo Sonic (The Trilogy, Pt. 3)	3:03
A Tear in Space (Airlock)	Glass Animals	I Love You So F***ing Much [Explicit]	3:24
Tear It Down (From Hotel Transylvania 3)	Tiësto	Hotel Transylvania 3	2:40
Teenage Dirtbag	Walk Off the Earth	Teenage Dirtbag	3:19
Teeth	5 Seconds Of Summer	CALM [Explicit]	3:25
Telephone [feat. Beyoncé]	Lady Gaga	The Fame Monster [Explicit]	3:40
Tell It To My Heart [feat. Hozier]	Meduza [feat. Hozier]	Tell It To My Heart	2:45
Tell Me	Teddy Swims	I've Tried Everything But Therapy (Part 1.5)	2:56
Tempo (feat. Missy Elliott)	Lizzo	Cuz I Love You (Deluxe) [Explicit]	2:55
Temporary Love	The Brinks	Temporary Love	3:25
Ten Duel Commandments	Lin-Manuel Miranda	Hamilton (Original Broadway Cast Recording) [Explicit]	1:46
Tessellate	alt-J	An Awesome Wave	3:01
Texas Man	The Chicks	Gaslighter [Explicit]	3:45
Texas Sun	Khruangbin & Leon Bridges	Texas Sun	4:12
Thank Goodness (From "Wicked" Original Broadway Cast Recording/2003)	VARIOUS ARTISTS	Wicked	6:23
Thank You for the Cross	Vineyard Worship	Discover Vineyard Easter	4:57
That Christmas Feeling	Bing Crosby & Friends	Bing Crosby's Christmas Special	1:33
that way	Tate McRae	all the things i never said [Explicit]	2:55
That Would Be Enough	Lin-Manuel Miranda	Hamilton (Original Broadway Cast Recording) [Explicit]	2:58
THAT'S A JOKE	NF	CLOUDS (THE MIXTAPE)	3:50
THATS WHAT I WANT	Lil Nas X	MONTERO [Explicit]	2:24
The Schuyler Sisters	Lin-Manuel Miranda	Hamilton (Original Broadway Cast Recording) [Explicit]	3:06
Therapy Session	NF	Therapy Session	5:31
There Is A Power [feat. Dante Bowe]	Rita Springer [feat. Dante Bowe]	There Is A Power	9:17
There May Be Tears	Scott Cunningham Band	Come Away	4:29
There's a Fine, Fine Line	Original Broadway Cast of Avenue Q	Avenue Q (Original Broadway Cast Recording) [Explicit]	2:40
There's Nothing Holdin' Me Back	Shawn Mendes	Illuminate (Deluxe)	3:19
There's a World (2009 Remaster)	Neil Young	Harvest (2009 Remaster)	2:59
They Can't Take That Away From Me	Louis Armstrong & Ella Fitzgerald	Ella & Louis For Lovers (Deluxe Edition)	4:38
They Say It's Spring	Blossom Dearie	Give Him The Ooh-La-La (Expanded Edition)	3:46
Thief	Third Day	Third Day	4:24
Thinking About You	Edwin Raphael	Ocean Walk	1:07
This Feeling	The Chainsmokers	Sick Boy	3:17
This Is Amazing Grace	Phil Wickham	The Ascension (Deluxe)	4:39
This Is Me	VARIOUS ARTISTS	The Greatest Showman (Original Motion Picture Soundtrack)	3:54
This Is Not A Test [feat. Capital Kings]	TobyMac	This Is Not A Test (Deluxe Edition)	2:39
This Land Is Your Land	Neil Young & Crazy Horse	Americana [+video]	5:22
This My Inheritance (feat. Leslie Jordan & David Leonard)	All Sons & Daughters [feat. Leslie Jordan & David Leonard]	Poets & Saints (feat. Leslie Jordan & David Leonard)	3:57
This Time	August Rush (Motion Picture Soundtrack)	August Rush (Soundtrack)	4:11
A Thousand Years	The Piano Guys	10	4:30
Thriller / Heads Will Roll	Glee Cast	Glee: The Music, Volume 5	3:36
Throne Room	Kim Walker-Smith	On My Side	4:44
Thumbs	Sabrina Carpenter	EVOLution	3:36
Thunder	VARIOUS ARTISTS	Best Of 2017 [Explicit]	3:08
Thunderstruck	Tommee Profitt & William Joseph	Thunderstruck	5:08
Tightrope	VARIOUS ARTISTS	The Greatest Showman (Original Motion Picture Soundtrack)	3:54
Tights On My Boat	The Chicks	Gaslighter [Explicit]	3:02
Til The Day I Die [feat. NF]	TobyMac	This Is Not A Test (Deluxe Edition)	3:47
Timber	Pitbull	Global Warming: Meltdown (Deluxe Version) [Clean]	3:24
Timbercats	VARIOUS ARTISTS	Kipo And The Age Of Wonderbeasts (Season 1 Mixtape) [Clean]	0:42
Time (Edit)	NF	The Search	3:50
Time Of Your Song (Album Version)	Matisyahu	Youth	4:26
Tip Toe (feat. French Montana)	Jason Derulo [feat. French Montana]	Tip Toe (feat. French Montana)	3:07
Tired Eyes (2017 Remaster)	Neil Young	Decade	4:33
Titles from Chariots of Fire	2Cellos	Score	3:40
To Be Better	Miracle Of Sound	Level 12 [Explicit]	3:30
To Be Free	VARIOUS ARTISTS	Aladdin (Original Motion Picture Soundtrack)	1:39
To Break In a Glove	VARIOUS ARTISTS	Dear Evan Hansen (Original Broadway Cast Recording)	3:50
To Keep My Love Alive	Ella Fitzgerald	Ella Fitzgerald Sings The Rodgers And Hart Song Book	3:36
To The Moon	Meghan Trainor	Timeless [Explicit]	2:29
To Those Who Wait	Bethany Dillon	To Those Who Wait (Live)	5:59
Toby's Mac (Interlude)	TobyMac	Momentum	0:45
Toes	Glass Animals	ZABA [Explicit]	4:14
Tokyo Drifting	Glass Animals	Dreamland [Explicit]	3:36
Tom Dula	Neil Young & Crazy Horse	Americana [+video]	8:11
Tomorrow Is a Latter Day	Trey Parker, Robert Lopez & Matt Stone	The Book Of Mormon (Original Broadway Cast Recording) [Explicit]	6:01
Tomorrow Is A Long Time	Nickel Creek	Why Should The Fire Die?	3:36
Tongues & Teeth	The Crane Wives	The Fool in Her Wedding Gown	3:41
TONIGHT (Bad Boys: Ride Or Die)	Black Eyed Peas & El Alfa [feat. Becky G]	TONIGHT (Bad Boys: Ride Or Die)	3:38
Tonight's the Night (Pt. 1) [2017 Remaster]	Neil Young	Decade	4:41
Too Close	Alex Clare	The Lateness Of The Hour [Explicit]	4:16
Tootie's Grief	VARIOUS ARTISTS	Meet Me In St. Louis (Original Motion Picture Soundtrack)	1:57
Tootie's Music Box	VARIOUS ARTISTS	Meet Me In St. Louis (Original Motion Picture Soundtrack)	1:46
Topsy Turvy, Pt. 1	VARIOUS ARTISTS	The Hunchback of Notre Dame (Studio Cast Recording)	2:05
Toxic	VARIOUS ARTISTS	Pitch Perfect 3 (Original Motion Picture Soundtrack - Special Edition)	3:21
Toxic (The Voice Performance)	Melanie Martinez	Toxic (The Voice Performance)	3:49
Toxicity	System Of A Down	Toxicity	3:38
Trampoline	SHAED	MELT	3:04
Transformation	VARIOUS ARTISTS	Beauty and the Beast	5:49
Travel On	Neil Young & Crazy Horse	Americana [+video]	6:44
The Traveling Song	VARIOUS ARTISTS	Madagascar: Escape 2 Africa (Music From The Motion Picture)	3:25
Treetop Butterflies	VARIOUS ARTISTS	Kipo And The Age Of Wonderbeasts (Season 3 Mixtape)	1:10
Tremble (Live)	Mosaic MSC	Glory & Wonder	5:09
Tricky Tricky	W&W, Timmy Trumpet & Will Sparks [feat. Sequenza]	Tricky Tricky	2:42
The Trip - 2023 Remaster	Still Corners	Strange Pleasures - 10th Anniversary Edition	6:13
Triple Skinny (Interlude)	TobyMac	Momentum	0:32
The Trolley Song	VARIOUS ARTISTS	Meet Me In St. Louis (Original Motion Picture Soundtrack)	4:04
TROUBLE (feat. Nikki Williams)	Parov Stelar [feat. Nikki Williams]	TROUBLE (feat. Nikki Williams)	3:12
Tru-Dog (Interlude)	TobyMac	Momentum	1:06
TruDog: The Return	TobyMac	Welcome To Diverse City	2:22
TRUST [feat. Tech N9ne]	NF	CLOUDS (THE MIXTAPE)	4:24
Trust at Twilights Hold	The Riverside	From the Deep Valley	2:51
Trust in You	Lauren Daigle	How Can It Be (Deluxe Edition)	3:31
Truth Hurts	Lizzo	Truth Hurts [Explicit]	2:53
Truth Hurts	Lizzo	Cuz I Love You (Deluxe) [Explicit]	2:53
Tu sais	Tepr & Arm	Tu sais	3:25
Tulips & Roses	G-Eazy	Tulips & Roses [Clean]	3:16
Tupelo Shuffle	VARIOUS ARTISTS	ELVIS (Original Motion Picture Soundtrack) [Explicit]	2:48
Turn It Off	Trey Parker, Robert Lopez & Matt Stone	The Book Of Mormon (Original Broadway Cast Recording) [Explicit]	5:03
Turn It Up	Armin van Buuren	Turn It Up (Remixes)	2:52
Turn Me On (Feat. Nicki Minaj)	David Guetta	Nothing but the Beat [Explicit]	3:19
TURN MY BACK	NF	HOPE	3:36
Turning	Les Misérables Cast	Les Misérables: The Motion Picture Soundtrack Deluxe (Deluxe Edition)	0:38
Turning Tables (Glee Cast Version Featuring Gwyneth Paltrow)	Glee Cast	Glee: The Music, Volume 6	4:06
Twelve Days Of Christmas [feat. The Andrews Sisters]	Bing Crosby	The Voice Of Christmas - The Complete Decca Christmas Songbook	3:23
Two	Sleeping At Last	Atlas: Enneagram	4:18
Two by Two	Trey Parker, Robert Lopez & Matt Stone	The Book Of Mormon (Original Broadway Cast Recording) [Explicit]	4:31
U&ME	alt-J	The Dream [Explicit]	3:18
UFO (Radio Edit)	Vigiland	UFO	2:24
Undeniable	TobyMac	This Is Not A Test (Deluxe Edition)	3:41
Undeniable You	Jukebox The Ghost	Jukebox The Ghost	3:21
Under the Anheuser Bush	VARIOUS ARTISTS	Meet Me In St. Louis (Original Motion Picture Soundtrack)	1:41
Under the Bamboo Tree	VARIOUS ARTISTS	Meet Me In St. Louis (Original Motion Picture Soundtrack)	1:38
Under The Milky Way	The Temper Trap	Under The Milky Way	4:20
Under My Skin	Jukebox The Ghost	Let Live & Let Ghosts	3:20
Under My Skin	VARIOUS ARTISTS	Straight Out The Oven 2011 Summer Sampler	6:59
Undo It	Carrie Underwood	Greatest Hits: Decade #1	2:57
Unholy	Sam Smith & Kim Petras	Unholy	2:37
Unknown Legend	Neil Young	Harvest Moon	4:32
Unraveling	Cory Asbury	To Love a Fool	4:39
Unsteady	X Ambassadors	VHS [Explicit]	3:13
Unstoppable	The Score	ATLAS [Explicit]	3:12
Until it Sleeps	Scott D. Davis	Pianotarium - Piano Tribute to Metallica	4:27
Until We Get There	Lucius	Wildewoman (Expanded Edition)	3:28
Up All Night	Oliver Tank	Dreams	3:10
UP!	Forrest Frank & Connor Price	UP!	2:17
Use Somebody	2Cellos	2CELLOS	3:27
Used To Be (feat. Wiz Khalifa)	Steve Aoki & Kiiara [feat. Wiz Khalifa]	Used To Be (feat. Wiz Khalifa)	3:40
Valjean Arrested/Valjean Forgiven	VARIOUS ARTISTS	Les Misérables (Original Broadway Cast Recording)	1:52
Valjean's Soliloquy	Les Misérables Cast	Les Misérables: The Motion Picture Soundtrack Deluxe (Deluxe Edition)	3:18
Valjean's Soliloquy (Live)	Claude-Michel Schönberg & Alain Boublil	Les Misérables Live! (2010 London Cast Recording)	3:02
Valjean’s Confession	Les Misérables Cast	Les Misérables: The Motion Picture Soundtrack Deluxe (Deluxe Edition)	2:17
Vegas	VARIOUS ARTISTS	ELVIS (Original Motion Picture Soundtrack) [Explicit]	3:03
Venom (Music From The Motion Picture)	Eminem	Venom (Music From The Motion Picture) [Clean]	4:29
Vermland	AndreasBeats	Vermland	2:53
A Very Nice Prince	VARIOUS ARTISTS	Into the Woods (Original Motion Picture Soundtrack)	1:29
A Very Nice Prince / First Midnight / Giants in the Sky	Original Broadway Cast of Into the Woods	Into the Woods (Original Broadway Cast Recording)	5:20
La Vie En Rose	VARIOUS ARTISTS	Jazz Masters Greatest Hits	3:24
La vie en rose (feat. Cécile McLorin Salvant)	Michael Bublé	love (Deluxe Edition)	3:50
VILLAIN	K/DA	ALL OUT	3:19
Vindicated	Dashboard Confessional	The Best Ones of the Best Ones	3:21
Violence	blink-182	blink-182 [Explicit]	3:39
The Virginia Company	VARIOUS ARTISTS	Pocahontas	1:30
virgo	Jadu Jadu	virgo	1:01
Las Vistas	VARIOUS ARTISTS	Kipo And The Age Of Wonderbeasts (Season 3 Mixtape)	1:53
Viva La Vida	2Cellos	2CELLOS	3:41
Vois sur ton chemin (Techno Mix)	BENNETT	Vois sur ton chemin (Techno Mix)	2:58
Volcano Man	VARIOUS ARTISTS	Eurovision Song Contest: The Story of Fire Saga (Music from the Netflix Film)	1:21
Wait by the River	Lord Huron	Vide Noir	3:11
Wait for It	Lin-Manuel Miranda	Hamilton (Original Broadway Cast Recording) [Explicit]	3:13
Wait for Me	Anaïs Mitchell	Hadestown (Original Broadway Cast Recording)	3:34
Wait for Me ("Hey, the big artiste...") [Intro]	Anaïs Mitchell	Hadestown (Original Broadway Cast Recording)	1:31
Wait for Me ("If you wanna walk out of hell...") [Intro] [Reprise]	Anaïs Mitchell	Hadestown (Original Broadway Cast Recording)	1:36
Wait for Me (Reprise)	Anaïs Mitchell	Hadestown (Original Broadway Cast Recording)	3:12
Wait A Minute [feat. Timbaland]	The Pussycat Dolls	PCD	3:42
Wait On You	Elevation Worship & Maverick City Music	Old Church Basement	9:24
Walk Me Home	P!nk	Hurts 2B Human [Explicit]	2:59
Walk a Mile	alt-J	The Dream [Explicit]	6:29
Walk On (2017 Remaster)	Neil Young	Decade	2:41
Walk With Me	Neil Young	Le Noise [+Digital Booklet]	4:24
Walking On Air	Katy Perry	Prism (Deluxe Version)	3:42
Walking the Wire / Largo	The Piano Guys	Limitless	4:18
War Cry	Queen Naija	War Cry	5:06
War of Man	Neil Young	Harvest Moon	5:43
Warsaw Concerto (arr. R. Douglas): Warsaw Concerto	VARIOUS ARTISTS	Best of British Light Music	9:06
Washing over Me (feat. Morning Parade)	Goldfish	Three Second Memory (Deluxe)	3:23
Washington on Your Side	Lin-Manuel Miranda	Hamilton (Original Broadway Cast Recording) [Explicit]	3:01
WATATI (feat. Aldo Ranks)	VARIOUS ARTISTS	Barbie The Album	2:47
Watch Me (Whip / Nae Nae)	Silentó	Watch Me (Whip / Nae Nae)	3:05
Watch The World Burn	Falling In Reverse	Watch The World Burn [Explicit]	3:24
Water	Menomena	Under an Hour	17:52
Water Me	Lizzo	Cuz I Love You (Deluxe) [Explicit]	3:05
Waterfalls Coming Out Your Mouth	Glass Animals	Dreamland [Explicit]	2:41
Wave Rider (From Hotel Transylvania 3)	Tiësto	Hotel Transylvania 3	2:51
Waving Through A Window	VARIOUS ARTISTS	Dear Evan Hansen (Original Broadway Cast Recording)	3:56
Way Down	Monstercat	Monstercat - 8 Year Anniversary	4:23
Way Down Hadestown	Anaïs Mitchell	Hadestown (Original Broadway Cast Recording)	5:00
Way Down Hadestown (Reprise)	Anaïs Mitchell	Hadestown (Original Broadway Cast Recording)	3:50
Way down We Go	KALEO	A/B	3:33
The Way I Are [feat. Keri Hilson & D.O.E.]	Timbaland	Shock Value	2:59
The Way It Was	Coast Modern	Coast Modern	3:50
Wayfarin' Stranger	Neil Young & Crazy Horse	Americana [+video]	3:06
Waymaker	Michael W. Smith [feat. Vanessa Campagna & Madelyn Berry]	Waymaker	7:17
We Don't Talk About Bruno	Lin-Manuel Miranda, Germaine Franco & Encanto - Cast	Encanto (Original Motion Picture Soundtrack)	3:36
we fell in love in october	girl in red	we fell in love in october / forget her	3:04
We Know	Lin-Manuel Miranda	Hamilton (Original Broadway Cast Recording) [Explicit]	2:22
We Know The Way	VARIOUS ARTISTS	Moana (Original Motion Picture Soundtrack)	2:21
We No Speak Americano	Yolanda Be Cool & Dcup	We No Speak Americano	4:29
We Open Our Hearts (Live)	TFH Worship	Pursuit (Live)	7:03
We Raise Our Cups	Anaïs Mitchell	Hadestown (Original Broadway Cast Recording)	2:05
We Three Kings	Tommee Profitt	The Birth Of A King	4:10
We Three Kings	The Piano Guys	A Family Christmas	3:14
We Will Find Them	VARIOUS ARTISTS	Kipo And The Age Of Wonderbeasts (Season 1 Mixtape) [Clean]	2:08
We Will Run	Gungor	Beautiful Things	9:24
Weak	AJR	The Click (Deluxe Edition) [Explicit]	3:21
Weary Blues	Madeleine Peyroux	Careless Love	3:40
The Wedding	Les Misérables Cast	Les Misérables: The Motion Picture Soundtrack Deluxe (Deluxe Edition)	2:02
Wedding Song	Anaïs Mitchell	Hadestown (Original Broadway Cast Recording)	3:33
Weird	Menomena	Friend And Foe	3:05
Welcome to the Jungle	2Cellos	2CELLOS	3:08
Welcome To New York	Taylor Swift	1989	3:32
Wellerman	The Longest Johns	Between Wind And Water	2:16
Wet And Rusting	Menomena	Friend And Foe	3:33
What About Everything?	Carbon Leaf	Indian Summer	3:44
What About Me (Radio Edit)	Cascada	Evacuate The Dancefloor	3:11
What A Beautiful Name	Hillsong Worship & Brooke Ligertwood	What A Beautiful Name	3:58
What Child is This	The Piano Guys	Christmas Together	2:58
What Child Is This?	Tommee Profitt	The Birth Of A King	3:34
What Child Is This/The Holly And The Ivy (Medley / Remastered 2006)	Bing Crosby	Bing Crosby - Christmas Classics	3:21
What Comes Next?	Lin-Manuel Miranda	Hamilton (Original Broadway Cast Recording) [Explicit]	1:39
What Could've Been	Gone West	Canyons	3:42
What Goes Around.../...Comes Around (Interlude)	Justin Timberlake	FutureSex/LoveSounds Deluxe Edition [Clean]	7:28
What Have I Done?	VARIOUS ARTISTS	Les Misérables (Original Broadway Cast Recording)	3:21
What Ifs	Kane Brown	Kane Brown	3:08
What Is This Feeling? (From "Wicked" Original Broadway Cast Recording/2003)	VARIOUS ARTISTS	Wicked	3:32
What Kind Of Man	Florence + The Machine	How Big, How Blue, How Beautiful (Deluxe)	3:36
What Was I Made For?	VARIOUS ARTISTS	Barbie The Album	3:42
What We Have Is You	VARIOUS ARTISTS	Kipo And The Age Of Wonderbeasts (Season 1 Mixtape) [Clean]	1:26
What'd I Miss	Lin-Manuel Miranda	Hamilton (Original Broadway Cast Recording) [Explicit]	3:56
What's Goin' Down	TobyMac	Momentum	3:42
What's My Name	Descendants 2 – Cast & Disney	Descendants 2 (Original TV Movie Soundtrack)	3:10
Whatcha Say	Jason Derulo	Jason Derulo	3:41
Whatever It Takes	Imagine Dragons	Evolve	3:21
Whatever Lola Wants (Lola Gets)	Sarah Vaughan	Sarah Vaughan's Golden Hits	2:37
Whatever Will Be, Will Be (Que Sera, Sera)	Doris Day	The Magic Of Doris Day	2:06
whatthehellishappening?	Glass Animals	I Love You So F***ing Much [Explicit]	3:45
When the Chips are Down	Anaïs Mitchell	Hadestown (Original Broadway Cast Recording)	2:14
When the Chips are Down ("Songbird vs. rattlesnake...") [Intro]	Anaïs Mitchell	Hadestown (Original Broadway Cast Recording)	0:20
When I Am Older	VARIOUS ARTISTS	Frozen 2 (Original Motion Picture Soundtrack)	1:51
When I Grow Up	NF	The Search	3:16
When I Grow Up	The Pussycat Dolls	Doll Domination - The Mini Collection	4:05
When I'm Alone	Goldfish & Łaszewo	When I'm Alone	3:20
When I'm Gone	Alesso & Katy Perry	When I'm Gone	2:41
When In Rome	Nickel Creek	Why Should The Fire Die?	4:15
when the party's over	Billie Eilish	WHEN WE ALL FALL ASLEEP, WHERE DO WE GO?	3:16
when the party's over	Billie Eilish	when the party's over	3:19
When She Loved Me (From "Toy Story 2")	VARIOUS ARTISTS	Disney/Pixar Greatest	3:05
When the Sun Goes Down	Lin-Manuel Miranda	In the Heights (Original Broadway Cast Recording)	2:32
When We're Human [feat. Terence Blanchard]	VARIOUS ARTISTS	The Princess and the Frog (Original Motion Picture Soundtrack)	2:22
When Will My Life Begin (Reprise 2) (From "Tangled"/Soundtrack Version)	VARIOUS ARTISTS	Tangled	2:06
When You Believe	VARIOUS ARTISTS	The Prince Of Egypt (Music From The Original Motion Picture Soundtrack)	4:55
When You're Home	Lin-Manuel Miranda	In the Heights (Original Broadway Cast Recording)	5:20
When You're Smiling (The Whole World Smiles With You) (With Intro)	Louis Armstrong	All Time Greatest Hits	4:06
Where Are You Christmas	The Piano Guys	A Family Christmas	3:55
Where Are You Now	Lost Frequencies & Calum Scott	Where Are You Now	2:28
Where Did the Rock Go	Andrew Lloyd Webber	School of Rock: The Musical (Original Cast Recording)	4:14
Where I Want to Be	VARIOUS ARTISTS	Chess In Concert	3:30
Where The Streets Have No Name	2Cellos	2CELLOS	4:02
Where Them Girls At (feat. Nicki Minaj & Flo Rida) [Afrojack Remix]	David Guetta	Where Them Girls At (feat. Nicki Minaj & Flo Rida) (Afrojack Remix)	6:26
Where Them Girls At (Feat. Nicki Minaj & Flo Rida)	David Guetta	Nothing but the Beat [Explicit]	3:30
Where You Are	VARIOUS ARTISTS	Moana (Original Motion Picture Soundtrack)	3:30
Where You Go I'll Go	Brian and Jenn Johnson	We Believe	10:04
Where's My Love (Acoustic)	SYML	Where's My Love	3:59
Whippin (feat. Felix Snow)	Kiiara [feat. Felix Snow]	Whippin (feat. Felix Snow) [Explicit]	2:40
White Christmas (Remastered 2006)	Bing Crosby	Bing Crosby - Christmas Classics	1:34
White Roses	Glass Animals	I Love You So F***ing Much [Explicit]	3:38
White Walls (feat. ScHoolboy Q & Hollis)	Macklemore & Ryan Lewis	The Heist [Explicit]	3:40
White Waters	Epica	Design Your Universe (Gold Edition: Deluxe Edition)	4:44
Who Am I?	VARIOUS ARTISTS	Les Misérables (Original Broadway Cast Recording)	2:48
Who Am I? (From "Les Miserables'')	Les Misérables Cast	Les Misérables: The Motion Picture Soundtrack Deluxe (Deluxe Edition)	2:37
Who I Am Hates Who I've Been	Relient K	Mmhmm10	3:52
Who Lives, Who Dies, Who Tells Your Story	Lin-Manuel Miranda	Hamilton (Original Broadway Cast Recording) [Explicit]	3:37
Who You Say I Am (Studio Version)	Hillsong Worship	Who You Say I Am (Studio Version)	3:18
Why Should The Fire Die?	Nickel Creek	Why Should The Fire Die?	2:50
Why We Build the Wall	Anaïs Mitchell	Hadestown (Original Broadway Cast Recording)	4:00
Why We Build the Wall ("Behind closed doors...") [Outro]	Anaïs Mitchell	Hadestown (Original Broadway Cast Recording)	0:57
Why You Had To Leave (Radio Edit)	Cascada	Evacuate The Dancefloor	3:37
Wild Child	The Black Keys	Dropout Boogie	2:45
Wild West Show	Big & Rich	Horse of a Different Color	4:20
Wildest Dreams	Duomo	Berlin:Redux	3:26
Wildflower	the JaneDear girls	The JaneDear Girls	2:43
Will Do	TV On The Radio	Nine Types Of Light	3:45
Winter	Two Feet	Shape & Form (Deluxe) [Explicit]	3:31
Winter - Lux Aeterna (From "Requiem for a Dream")	VARIOUS ARTISTS	Cult Cuts	4:02
Winter In St. Louis	VARIOUS ARTISTS	Meet Me In St. Louis (Original Motion Picture Soundtrack)	0:46
Winter Wind	The Piano Guys	A Family Christmas	4:24
Winter Wonderland	Amy Grant	Home For Christmas	2:17
Winter Wonderland (Remastered 2006)	Bing Crosby	Bing Crosby - Christmas Classics	2:24
Winter Wonderland / Here Comes Santa Claus (From "Pitch Perfect 2" Soundtrack)	VARIOUS ARTISTS	Pitch Perfect 2 - Special Edition (Original Motion Picture Soundtrack)	3:04
A Winter's Ball	Lin-Manuel Miranda	Hamilton (Original Broadway Cast Recording) [Explicit]	1:09
Winterlong (2017 Remaster)	Neil Young	Decade	3:08
Witch's Lament	VARIOUS ARTISTS	Into the Woods (Original Motion Picture Soundtrack)	1:14
With Or Without You	2Cellos	2CELLOS	4:51
With You	Elevation Worship	At Midnight - EP	10:01
With You (Paradoxology)	Elevation Worship	With You (Paradoxology)	6:05
Without Me	Eminem	The Eminem Show [Explicit]	4:50
WITHOUT YOU	The Kid LAROI	F*CK LOVE 3+: OVER YOU [Clean]	2:41
Without You (Ryan Exley Remix)	Illenium	Ashes (Remixes)	6:21
The Wizard And I (From "Wicked" Original Broadway Cast Recording/2003)	VARIOUS ARTISTS	Wicked	5:09
Wolf Chase	VARIOUS ARTISTS	Kipo And The Age Of Wonderbeasts (Season 1 Mixtape) [Clean]	1:16
Wolf Totem (feat. Jacoby Shaddix of Papa Roach)	The HU & Jacoby Shaddix [feat. Papa Roach]	Wolf Totem (feat. Jacoby Shaddix of Papa Roach)	5:17
Wolves	Selena Gomez & Marshmello	Wolves	3:18
Woman	Kesha	Rainbow [Explicit]	3:16
Woman	Kesha	Rainbow [Explicit]	3:16
Won't Stop Now	Elevation Worship	Hallelujah Here Below	7:04
Wonderful (From "Wicked" Original Broadway Cast Recording/2003)	VARIOUS ARTISTS	Wicked	4:57
Wonderful Nothing	Glass Animals	I Love You So F***ing Much [Explicit]	4:24
Wonderin' Why	TobyMac	Momentum	3:42
Wonderland	Caravan Palace	Wonderland	3:11
Woodland	The Paper Kites	Woodland	3:51
Word to the Wise	Anaïs Mitchell	Hadestown (Original Broadway Cast Recording)	1:20
Words (Between the Lines of Age) [2009 Remaster]	Neil Young	Harvest (2009 Remaster)	6:47
Words Fail	VARIOUS ARTISTS	Dear Evan Hansen (Original Broadway Cast Recording)	5:51
Work Song	Hozier	Hozier	3:49
World Burn	Reneé Rapp & Auli'i Cravalho	Mean Girls (Music From The Motion Picture) [Explicit]	3:36
The World Es Mi Familia	VARIOUS ARTISTS	Coco (Original Motion Picture Soundtrack)	0:50
World In Flames	In This Moment	A Star-Crossed Wasteland	5:20
A World of Wonderbeasts	VARIOUS ARTISTS	Kipo And The Age Of Wonderbeasts (Season 3 Mixtape)	1:09
World on Fire	Stick Figure [feat. Slightly Stoopid]	World on Fire	4:00
The World Was Wide Enough	Lin-Manuel Miranda	Hamilton (Original Broadway Cast Recording) [Explicit]	5:02
Worlds On Fire [feat. Au/Ra]	Afrojack & R3HAB [feat. Au/Ra]	Worlds On Fire	2:54
Worth It	Fifth Harmony	Reflection (Deluxe)	3:44
Worth It [feat. Kid Ink]	VARIOUS ARTISTS	NOW That's What I Call A Workout 2017	3:42
WOW	Tiësto	WOW	2:28
Wriggle	Cosmo Sheldrake	The Much Much How How and I	4:29
Yahweh	Elevation Worship	Here As In Heaven	6:43
Yeah!	USHER	Confessions (Expanded Edition) [Clean]	4:10
Yes I Will	Vertical Worship	Bright Faith Bold Future	3:54
Yes I'm A Mess	AJR	The Maybe Man [Explicit]	2:45
YES MOM	Tessa Violet	YES MOM	2:42
Yes to Heaven	xryomeister	Yes to Heaven	3:35
Yorktown (The World Turned Upside Down)	Lin-Manuel Miranda	Hamilton (Original Broadway Cast Recording) [Explicit]	4:02
You and I	VARIOUS ARTISTS	Meet Me In St. Louis (Original Motion Picture Soundtrack)	2:33
You and Me	Neil Young	Harvest Moon	3:45
You and Me (But Mostly Me)	Trey Parker, Robert Lopez & Matt Stone	The Book Of Mormon (Original Broadway Cast Recording) [Explicit]	2:43
You Are Love & Love Alone (feat. Leslie Jordan & David Leonard)	All Sons & Daughters [feat. Leslie Jordan & David Leonard]	Poets & Saints (feat. Leslie Jordan & David Leonard)	4:34
You Are My Sunshine (This Little Light of Mine)	VARIOUS ARTISTS	Hawaiian Lullaby	3:46
You Belong to Me	Jo Stafford	The Columbia Hits Collection	3:06
you broke me first	Tate McRae	TOO YOUNG TO BE SAD [Explicit]	2:50
You Broke Up with Me	Walker Hayes	boom.	3:16
You Do Something To Me	Ella Fitzgerald	Ella Fitzgerald Sings The Cole Porter Song Book (Expanded Edition)	2:22
You Don't Own Me	SAYGRACE	FMA [Explicit]	3:21
You Have Me	Gungor	Beautiful Things	4:35
You Hold It All Together (feat. Leslie Jordan & David Leonard)	All Sons & Daughters [feat. Leslie Jordan & David Leonard]	Poets & Saints (feat. Leslie Jordan & David Leonard)	4:42
You Look Good	VARIOUS ARTISTS	Beat The Heat Country Summer Jams	3:01
You Make Me Feel...(Feat. Sabi)	Cobra Starship	Night Shades [Explicit]	3:35
You Will Be Found	VARIOUS ARTISTS	Dear Evan Hansen (Original Broadway Cast Recording)	6:00
You?	Two Feet	Pink [Explicit]	2:49
You'll Be Back	Lin-Manuel Miranda	Hamilton (Original Broadway Cast Recording) [Explicit]	3:28
You're Going Down	SICK PUPPIES	Tri-polar [Explicit]	3:07
You're A Mean One, Mr. Grinch	Pentatonix	The Best Of Pentatonix Christmas	3:00
You're Somebody Else	flora cash	You're Somebody Else	3:38
You're Welcome	VARIOUS ARTISTS	Moana (Original Motion Picture Soundtrack)	2:43
You've Got The Love	Florence + The Machine	Lungs	2:48
You've Got Me Running in Circles	Sonny Cleveland	Sonny Cleveland	2:51
Young And Beautiful	Lana Del Rey	Young And Beautiful	3:56
Young Man	The Chicks	Gaslighter [Explicit]	4:10
Your Fault	VARIOUS ARTISTS	Into the Woods (Original Motion Picture Soundtrack)	1:57
Your Fault / Last Midnight	Original Broadway Cast of Into the Woods	Into the Woods (Original Broadway Cast Recording)	4:46
Your Glory / Nothing But The Blood [Live]	All Sons & Daughters	Live	8:57
Your Heart Is As Black As Night	Melody Gardot	My One And Only Thrill	2:42
Your Love (Déjà Vu)	Glass Animals	Your Love (Déjà Vu)	3:54
Your Love (Déjà Vu)	Glass Animals	Dreamland [Explicit]	3:54
Your Majesty Bee	VARIOUS ARTISTS	Kipo And The Age Of Wonderbeasts (Season 3 Mixtape)	0:51
Your Obedient Servant	Lin-Manuel Miranda	Hamilton (Original Broadway Cast Recording) [Explicit]	2:30
Your Promises	Elevation Worship	Wake Up The Wonder	4:58
Yours	TobyMac	Momentum	3:52
Youth of the Nation	P.O.D.	Satellite	4:16
Yumyan HammerMeow	VARIOUS ARTISTS	Kipo And The Age Of Wonderbeasts (Season 3 Mixtape)	1:36
Yumyan Hammerpaw	VARIOUS ARTISTS	Kipo And The Age Of Wonderbeasts (Season 1 Mixtape) [Clean]	2:01
Zip-A-Dee-Doo-Dah (From "Song Of The South" / Remastered 1992)	VARIOUS ARTISTS	Capitol Sings The Best Movie Songs: ''And The Winner Is''	2:51